fitness_score,loc,lloc,sloc,comment,multi,blank,avg_cyclomatic_complexity,maintainability_index,halstead_h1,halstead_h2,halstead_N1,halstead_N2,halstead_vocabulary,halstead_length,halstead_volume,halstead_difficulty,halstead_effort,halstead_time,halstead_bugs
1.3126487205214081,37,29,31,1,0,6,4,68.03666948,2,6,3,6,8,9,27,1,27,1.5,0.009
1.2190717369184731,40,32,32,0,0,8,9,51.457109245279845,5,13,9,18,18,27,112.58797503894243,3.4615384615384617,389.7276059040315,21.651533661335083,0.037529325
1.3646357649940557,52,37,38,2,4,10,7,72.87855951573236,4,8,8,14,12,22,78.86917501586544,3.5,276.0421126,15.33567291975161,0.026289725005288478
1.4550517921625103,47,31,32,2,7,8,5,80.6952462,4,7,5,10,11,15,51.89147427955947,2.857142857142857,148.26135508445563,8.236741949136423,0.017297158
1.2007738683517495,52,33,34,0,7,11,5,78.47704399172926,3,7,4,8,10,12,39.863137138648355,1.7142857142857142,68.33680652339717,3.796489251299843,0.013287712379549451
1.3472389147412946,54,35,38,2,4,10,7,71.25558901516112,6,14,13,24,20,37,159.91133951083242,5.142857142857143,822.4011746271382,45.688954145952124,0.05330378
1.0440633673061759,63,35,38,3,6,16,11,73.83214535560887,6,16,13,25,22,38,169.4584015082173,4.6875,794.3362570697685,44.12979205943159,0.056486134
1.3527799550319448,67,40,43,2,12,12,6,78.78252376050415,3,8,6,11,11,17,58.81033751683406,2.0625,121.29632112847025,6.738684507137236,0.019603445838944685
1.2774715937165757,41,31,31,6,0,5,0,77.70560859982224,4,7,5,9,11,14,48.43204266092217,2.5714285714285716,124.53953827094274,6.918863237274596,0.016144014220307392
1.5703062879912053,49,30,31,0,6,12,5,78.87735429616612,3,7,4,8,10,12,39.863137138648355,1.7142857142857142,68.33680652339717,3.796489251299843,0.013287712379549451
1.2473205640018892,47,35,37,1,0,10,7,61.53683807004875,4,12,7,14,16,21,84,2.3333333333333335,196,10.88888888888889,0.028
1.4968526287677622,53,36,36,0,6,11,8,72.79633805419711,5,10,9,16,15,25,97.67226489021297,4,390.6890595608519,21.70494775338066,0.032557422
1.4124921770230778,52,36,37,0,4,11,7,70.30129809323672,4,9,7,13,13,20,74.00879436282185,2.888888888888889,213.80318371481866,11.87795465082326,0.024669598120940616
1.5644102358874834,41,28,27,0,6,8,5,80.17984121529763,3,7,5,9,10,14,46.50699332842308,1.9285714285714286,89.69205856,4.982892142331044,0.015502331
0.8800150701096272,37,29,31,0,0,6,5,56.79413347052246,3,5,4,7,8,11,33,2.1,69.3,3.8499999999999996,0.011
1.3126487205214081,54,32,33,0,10,11,5,81.87096361627512,2,7,4,8,9,12,38.03910001730775,1.1428571428571428,43.47325716263743,2.415180953479857,0.012679700005769252
1.429963723798681,62,39,42,2,7,13,9,72.44334243848114,6,16,12,24,22,36,160.5395382709427,4.5,722.4279222192422,40.134884567735675,0.053513179
1.0440633673061759,48,32,31,5,6,11,13,76.18083743,5,24,16,34,29,50,242.89904975637864,3.5416666666666665,860.2674678871743,47.79263710484302,0.08096635
1.3527799550319448,57,39,40,0,7,10,8,73.60228622751019,3,10,6,12,13,18,66.60791492653966,1.8,119.8942468677714,6.660791492653967,0.022202638308846556
1.429963723798681,61,36,39,1,10,11,9,76.48407388986405,6,13,9,18,19,27,114.6940428629768,4.153846153846154,476.42140881544213,26.46785604530234,0.038231348
1.2982017926290197,57,35,36,1,11,10,5,81.65932300237455,2,7,4,8,9,12,38.03910001730775,1.1428571428571428,43.47325716263743,2.415180953479857,0.012679700005769252
1.4030189432939884,41,33,35,0,0,6,9,51.85639775208293,5,10,8,16,15,24,93.76537429460444,4,375.06149717841777,20.836749843245432,0.031255125
1.2573930450024826,58,39,42,1,6,10,6,74.12193404081665,3,9,5,10,12,15,53.77443751081735,1.6666666666666667,89.62406251802892,4.9791145843349405,0.017924812503605784
1.3126487205214081,59,48,49,3,0,10,13,59.99671337709119,7,17,14,27,24,41,187.98346252956745,5.5588235294117645,1044.9668946496543,58.05371636942524,0.062661154
1.0140323324148501,59,41,40,0,7,12,8,70.90675278422621,7,13,11,21,20,32,138.3016990363956,5.653846153846154,781.9365291673137,43.44091828707298,0.046100566
1.8253215861365861,70,48,50,16,0,16,11,72.64897854111491,8,18,15,28,26,43,202.11890788006698,6.222222222222222,1257.628760142639,69.86826445236883,0.067372969
1.741194311487682,64,42,43,10,5,13,9,76.61940664118141,5,11,9,17,16,26,104,3.8636363636363638,401.8181818181818,22.32323232323232,0.034666666666666665
1.650871428019163,44,36,37,4,0,7,5,70.39134623572906,6,9,7,14,15,21,82.04470251,4.666666666666667,382.8752783696349,21.27084879831305,0.027348234
1.5822386733354836,58,40,41,4,4,13,6,72.65250257235098,7,12,10,19,19,29,123.18989788986397,5.541666666666667,682.6773508063295,37.926519489240526,0.041063299
1.5703062879912053,49,30,31,0,6,12,5,78.87735429616612,3,7,4,8,10,12,39.863137138648355,1.7142857142857142,68.33680652339717,3.796489251299843,0.013287712379549451
1.5703062879912053,60,42,43,1,7,10,9,72.10335102786293,4,11,9,16,15,25,97.67226489021297,2.909090909090909,284.1374978624377,15.785416547913208,0.032557422
1.5698816540194096,53,36,36,2,6,11,8,75.13903920271056,5,10,9,16,15,25,97.67226489021297,4,390.6890595608519,21.70494775338066,0.032557422
1.5644102358874834,41,28,27,0,6,8,5,80.17984121529763,3,7,5,9,10,14,46.50699332842308,1.9285714285714286,89.69205856,4.982892142331044,0.015502331
1.5496757765116724,76,54,53,9,8,13,24,67.22289440341324,7,31,29,57,38,86,451.3217661561483,6.435483870967742,2904.4739467145673,161.35966370636484,0.1504405887187161
1.5033433960056493,63,45,43,6,7,13,8,74.34862751847487,6,13,11,21,19,32,135.93368043019473,4.846153846153846,658.7555282,36.59752934659089,0.045311227
1.4968526287677622,53,36,36,0,6,11,8,72.79633805419711,5,10,9,16,15,25,97.67226489021297,4,390.6890595608519,21.70494775338066,0.032557422
1.4968526287677622,59,41,41,5,7,11,8,76.00729025444525,5,10,9,16,15,25,97.67226489021297,4,390.6890595608519,21.70494775338066,0.032557422
1.4777192678242668,78,45,47,4,15,16,6,78.12640545864652,4,10,7,13,14,20,76.14709844115208,2.6,197.98245594699543,10.999025330388635,0.025382366147050694
1.4559888645303463,59,33,36,6,10,13,7,81.95243935763229,2,9,6,12,11,18,62.26976913547136,1.3333333333333333,83.02635884729514,4.612575491516397,0.020756589711823786
1.4559888645303463,71,41,43,3,13,13,11,75.40316633963786,8,17,13,26,25,39,181.11039140121426,6.117647058823529,1107.9694532780165,61.55385851544536,0.06037013
1.4550517921625103,47,31,32,2,7,8,5,80.6952462,4,7,5,10,11,15,51.89147427955947,2.857142857142857,148.26135508445563,8.236741949136423,0.017297158
1.438950434753381,66,43,45,4,7,14,9,71.62365045643075,7,22,15,30,29,45,218.60914478074076,4.7727272727272725,1043.3618273626264,57.96454596459036,0.072869715
1.4382358162444007,78,54,55,4,7,14,14,67.80143841446376,7,17,13,26,24,39,178.81353752812512,5.352941176470588,957.1783479446697,53.17657488581498,0.059604513
1.4318785057210348,65,43,45,6,7,13,6,74.35238383,7,14,12,23,21,35,153.73110979725664,5.75,883.9538813342257,49.10854896301254,0.051243703
1.429963723798681,62,39,42,2,7,13,9,72.44334243848114,6,16,12,24,22,36,160.5395382709427,4.5,722.4279222192422,40.134884567735675,0.053513179
1.429963723798681,61,36,39,1,10,11,9,76.48407388986405,6,13,9,18,19,27,114.6940428629768,4.153846153846154,476.42140881544213,26.46785604530234,0.038231348
1.4128359258563576,67,40,43,3,12,12,6,79.21869411,3,8,6,11,11,17,58.81033751683406,2.0625,121.29632112847025,6.738684507137236,0.019603445838944685
1.4124921770230778,52,36,37,0,4,11,7,70.30129809323672,4,9,7,13,13,20,74.00879436282185,2.888888888888889,213.80318371481866,11.87795465082326,0.024669598120940616
1.4124921770230778,56,36,37,9,5,11,7,79.85247076717228,4,9,7,13,13,20,74.00879436282185,2.888888888888889,213.80318371481866,11.87795465082326,0.024669598120940616
1.4030189432939884,41,33,35,0,0,6,9,51.85639775208293,5,10,8,16,15,24,93.76537429460444,4,375.06149717841777,20.836749843245432,0.031255125
1.9142149987260428,63,44,45,8,4,13,8,72.13923364746003,9,18,16,31,27,47,223.47971260168305,7.75,1731.9677726630437,96.22043181461353,0.074493238
1.862827217261968,77,51,56,16,4,15,10,71.69619067,8,23,20,38,31,58,287.3433860024388,6.608695652173913,1898.9649857552479,105.49805476418044,0.095781129
1.8253215861365861,70,48,50,16,0,16,11,72.64897854111491,8,18,15,28,26,43,202.11890788006698,6.222222222222222,1257.628760142639,69.86826445236883,0.067372969
1.8253215861365861,80,47,48,17,5,19,12,73.87337557,8,20,18,33,28,51,245.1751010249378,6.6,1618.1556667645893,89.89753704247718,0.081725034
1.7799344584102421,74,52,52,15,4,15,10,73.86867745859304,6,14,11,21,20,32,138.3016990363956,4.5,622.3576456637802,34.57542476,0.046100566
1.753474554669207,48,34,33,1,7,8,7,76.88840544,3,9,9,15,12,24,86.03910001730776,2.5,215.0977500432694,11.949875002403855,0.028679700005769252
1.741194311487682,64,42,43,10,5,13,9,76.61940664118141,5,11,9,17,16,26,104,3.8636363636363638,401.8181818181818,22.32323232323232,0.034666666666666665
1.741194311487682,65,42,43,10,6,13,9,76.99623186618498,5,11,9,17,16,26,104,3.8636363636363638,401.8181818181818,22.32323232323232,0.034666666666666665
1.741194311487682,62,44,44,3,3,15,6,68.28245953503789,7,15,11,22,22,33,147.1612434150308,5.133333333333334,755.4277161971582,41.96820645539768,0.049053748
1.6513410122129477,81,49,51,6,14,16,7,76.20532623,5,11,9,16,16,25,100,3.6363636363636362,363.6363636363636,20.2020202,0.033333333
1.650871428019163,44,36,37,4,0,7,5,70.39134623572906,6,9,7,14,15,21,82.04470251,4.666666666666667,382.8752783696349,21.27084879831305,0.027348234
1.650871428019163,70,50,50,0,7,13,12,65.51528031482802,6,22,14,28,28,42,201.90890672641936,3.8181818181818183,770.9249166,42.82916203287684,0.067302969
1.650871428019163,74,43,45,4,15,12,7,76.59381889,10,16,11,22,26,33,155.11451069865606,6.875,1066.4122610532604,59.24512561407002,0.051704837
1.650871428019163,70,44,44,3,13,12,10,75.14705632256248,7,16,12,23,23,35,158.32466846199546,5.03125,796.5709881994146,44.25394378885637,0.052774889
1.6255298762274717,63,45,43,7,7,13,8,74.84983226962036,6,13,11,21,19,32,135.93368043019473,4.846153846153846,658.7555282,36.59752934659089,0.045311227
1.5854375876597837,52,33,34,1,7,11,6,78.60930272842701,3,8,5,10,11,15,51.89147427955947,1.875,97.29651427,5.405361904120777,0.017297158
1.5822386733354836,58,40,41,4,4,13,6,72.65250257235098,7,12,10,19,19,29,123.18989788986397,5.541666666666667,682.6773508063295,37.926519489240526,0.041063299
1.5822386733354836,64,45,46,7,5,13,7,73.35420824,7,13,11,21,20,32,138.3016990363956,5.653846153846154,781.9365291673137,43.44091828707298,0.046100566
1.5703062879912053,49,30,31,0,6,12,5,78.87735429616612,3,7,4,8,10,12,39.863137138648355,1.7142857142857142,68.33680652339717,3.796489251299843,0.013287712379549451
1.5703062879912053,60,42,43,1,7,10,9,72.10335102786293,4,11,9,16,15,25,97.67226489021297,2.909090909090909,284.1374978624377,15.785416547913208,0.032557422
1.5703062879912053,60,39,39,2,7,14,5,74.54349915768788,5,15,9,18,20,27,116.69205856195879,3,350.07617568587636,19.44867642699313,0.038897353
1.5703062879912053,57,38,38,6,7,12,5,78.56934510262602,6,11,7,14,17,21,85.83671966625714,3.8181818181818183,327.74020236207275,18.207789020115154,0.02861224
1.5698816540194096,53,36,36,2,6,11,8,75.13903920271056,5,10,9,16,15,25,97.67226489021297,4,390.6890595608519,21.70494775338066,0.032557422
1.5698816540194096,66,45,45,1,7,13,8,71.21170331627572,5,10,9,16,15,25,97.67226489021297,4,390.6890595608519,21.70494775338066,0.032557422
1.5698816540194096,57,36,36,5,9,12,8,79.02003661,5,10,9,16,15,25,97.67226489021297,4,390.6890595608519,21.70494775338066,0.032557422
2.5163097261245135,91,63,62,18,4,20,13,68.21273161003077,10,30,26,50,40,76,404.4665352114396,8.333333333333334,3370.55446,187.25302556085165,0.1348221784038132
2.080869065910947,90,64,64,24,5,17,12,70.79154020467767,9,19,18,35,28,53,254.78981086905299,8.289473684210526,2112.0734322039916,117.33741290022175,0.084929937
1.9538178436815188,87,58,63,19,5,16,13,69.88280623,8,24,24,45,32,69,345,7.5,2587.5,143.75,0.115
1.9538178436815188,72,49,52,5,4,16,6,68.90547450099089,8,17,12,23,25,35,162.53496664211536,5.411764705882353,879.6009959455655,48.86672199697586,0.054178322214038455
1.9538178436815188,75,47,52,9,6,15,9,72.56032848167555,7,19,13,26,26,39,183.31714900750262,4.7894736842105265,877.9926610359337,48.77737005755187,0.061105716335834205
1.9422578078564976,65,44,45,10,6,13,5,75.52496489322746,7,19,12,22,26,34,159.81495041679716,4.052631578947368,647.6711148,35.98172860261222,0.05327165
1.9422578078564976,91,63,66,15,4,19,10,68.31097316314263,10,28,19,35,38,54,283.3880857259536,6.25,1771.175536,98.39864087706722,0.094462695
1.9142149987260428,63,44,45,8,4,13,8,72.13923364746003,9,18,16,31,27,47,223.47971260168305,7.75,1731.9677726630437,96.22043181461353,0.074493238
1.9142149987260428,68,46,47,14,5,14,8,73.32725873212743,9,25,21,41,34,62,315.4226961575211,7.38,2327.8194976425057,129.32330542458365,0.1051408987191737
1.862827217261968,77,51,56,16,4,15,10,71.69619067,8,23,20,38,31,58,287.3433860024388,6.608695652173913,1898.9649857552479,105.49805476418044,0.095781129
1.862827217261968,77,51,56,16,4,15,10,71.69619067,8,23,20,38,31,58,287.3433860024388,6.608695652173913,1898.9649857552479,105.49805476418044,0.095781129
1.8253215861365861,70,48,50,16,0,16,11,72.64897854111491,8,18,15,28,26,43,202.11890788006698,6.222222222222222,1257.628760142639,69.86826445236883,0.067372969
1.8253215861365861,80,47,48,17,5,19,12,73.87337557,8,20,18,33,28,51,245.1751010249378,6.6,1618.1556667645893,89.89753704247718,0.081725034
1.8253215861365861,75,52,52,4,4,17,14,64.43785573753708,8,24,21,39,32,60,300,6.5,1950,108.33333333333333,0.1
1.8253215861365861,75,40,42,18,5,20,12,75.79232239369757,8,20,18,33,28,51,245.1751010249378,6.6,1618.1556667645893,89.89753704247718,0.081725034
1.8253215861365861,96,52,54,18,15,21,13,72.95194648244866,8,21,19,35,29,54,262.33097373688895,6.666666666666667,1748.8731582459263,97.15961990255147,0.087443658
1.7799344584102421,74,52,52,15,4,15,10,73.86867745859304,6,14,11,21,20,32,138.3016990363956,4.5,622.3576456637802,34.57542476,0.046100566
1.7799344584102421,84,58,58,11,5,18,12,69.50899562,7,18,15,29,25,44,204.32967235008786,5.638888888888889,1152.1923190852178,64.01068439362321,0.068109891
1.7799344584102421,77,49,49,18,7,16,10,75.77996076462534,6,14,11,21,20,32,138.3016990363956,4.5,622.3576456637802,34.57542476,0.046100566
1.7637757549528568,68,45,48,1,4,16,6,65.05697485437814,7,21,14,27,28,41,197.10155180436175,4.5,886.9569831196279,49.27538795109044,0.065700517
1.753474554669207,48,34,33,1,7,8,7,76.88840544,3,9,9,15,12,24,86.03910001730776,2.5,215.0977500432694,11.949875002403855,0.028679700005769252
1.7449922747656967,82,44,49,19,5,21,6,74.29684878600564,7,32,23,46,39,69,364.69275310149516,5.03125,1834.8604140418975,101.9366896689943,0.12156425103383171
1.741194311487682,64,42,43,10,5,13,9,76.61940664118141,5,11,9,17,16,26,104,3.8636363636363638,401.8181818181818,22.32323232323232,0.034666666666666665
1.741194311487682,65,42,43,10,6,13,9,76.99623186618498,5,11,9,17,16,26,104,3.8636363636363638,401.8181818181818,22.32323232323232,0.034666666666666665
1.741194311487682,62,44,44,3,3,15,6,68.28245953503789,7,15,11,22,22,33,147.1612434150308,5.133333333333334,755.4277161971582,41.96820645539768,0.049053748
2.516309726,91,63,62,18,4,20,13,68.21273161,10,30,26,50,40,76,404.4665352,8.333333333,3370.55446,187.2530256,0.134822178
2.080869066,90,64,64,24,5,17,12,70.7915402,9,19,18,35,28,53,254.7898109,8.289473684,2112.073432,117.3374129,0.08492994
1.953817844,87,58,63,19,5,16,13,69.8828062,8,24,24,45,32,69,345,7.5,2587.5,143.75,0.115
1.953817844,72,49,52,5,4,16,6,68.9054745,8,17,12,23,25,35,162.5349666,5.411764706,879.6009959,48.866722,0.054178322
1.953817844,75,47,52,9,6,15,9,72.56032848,7,19,13,26,26,39,183.317149,4.789473684,877.992661,48.77737006,0.061105716
1.942257808,65,44,45,10,6,13,5,75.52496489,7,19,12,22,26,34,159.8149504,4.052631579,647.671115,35.9817286,0.05327165
1.942257808,91,63,66,15,4,19,10,68.31097316,10,28,19,35,38,54,283.3880857,6.25,1771.17554,98.39864088,0.0944627
1.914214999,63,44,45,8,4,13,8,72.13923365,9,18,16,31,27,47,223.4797126,7.75,1731.967773,96.22043181,0.07449324
1.914214999,68,46,47,14,5,14,8,73.32725873,9,25,21,41,34,62,315.4226962,7.38,2327.819498,129.3233054,0.105140899
1.862827217,77,51,56,16,4,15,10,71.6961907,8,23,20,38,31,58,287.343386,6.608695652,1898.964986,105.4980548,0.09578113
1.862827217,77,51,56,16,4,15,10,71.6961907,8,23,20,38,31,58,287.343386,6.608695652,1898.964986,105.4980548,0.09578113
1.825321586,70,48,50,16,0,16,11,72.64897854,8,18,15,28,26,43,202.1189079,6.222222222,1257.62876,69.86826445,0.06737297
1.825321586,80,47,48,17,5,19,12,73.8733756,8,20,18,33,28,51,245.175101,6.6,1618.155667,89.89753704,0.08172503
1.825321586,75,52,52,4,4,17,14,64.43785574,8,24,21,39,32,60,300,6.5,1950,108.3333333,0.1
1.825321586,75,40,42,18,5,20,12,75.79232239,8,20,18,33,28,51,245.175101,6.6,1618.155667,89.89753704,0.08172503
1.825321586,96,52,54,18,15,21,13,72.95194648,8,21,19,35,29,54,262.3309737,6.666666667,1748.873158,97.1596199,0.08744366
1.779934458,74,52,52,15,4,15,10,73.86867746,6,14,11,21,20,32,138.301699,4.5,622.3576457,34.5754248,0.04610057
1.779934458,84,58,58,11,5,18,12,69.5089956,7,18,15,29,25,44,204.3296724,5.638888889,1152.192319,64.01068439,0.06810989
1.779934458,77,49,49,18,7,16,10,75.77996076,6,14,11,21,20,32,138.301699,4.5,622.3576457,34.5754248,0.04610057
1.763775755,68,45,48,1,4,16,6,65.05697485,7,21,14,27,28,41,197.1015518,4.5,886.9569831,49.27538795,0.06570052
1.753474555,48,34,33,1,7,8,7,76.8884054,3,9,9,15,12,24,86.03910002,2.5,215.09775,11.949875,0.0286797
1.744992275,82,44,49,19,5,21,6,74.29684879,7,32,23,46,39,69,364.6927531,5.03125,1834.860414,101.9366897,0.121564251
1.741194311,64,42,43,10,5,13,9,76.61940664,5,11,9,17,16,26,104,3.863636364,401.8181818,22.32323232,0.034666667
1.741194311,65,42,43,10,6,13,9,76.99623187,5,11,9,17,16,26,104,3.863636364,401.8181818,22.32323232,0.034666667
1.741194311,62,44,44,3,3,15,6,68.28245954,7,15,11,22,22,33,147.1612434,5.133333333,755.4277162,41.96820646,0.04905375
2.516309726,91,63,62,18,4,20,13,68.21273161,10,30,26,50,40,76,404.4665352,8.333333333,3370.55446,187.2530256,0.134822178
2.516309726,88,58,59,16,4,20,13,68.71614684,10,30,26,50,40,76,404.4665352,8.333333333,3370.55446,187.2530256,0.134822178
2.516309726,98,67,66,23,5,20,14,68.02324661,10,33,29,56,43,85,461.2325041,8.484848485,3913.487914,217.4159952,0.153744168
2.516309726,93,62,62,17,4,22,13,68.07926053,10,30,26,50,40,76,404.4665352,8.333333333,3370.55446,187.2530256,0.134822178
2.516309726,93,67,67,8,4,18,15,61.71593127,10,34,30,58,44,88,480.4299824,8.529411765,4097.785144,227.6547302,0.160143327
2.080869066,90,64,64,24,5,17,12,70.7915402,9,19,18,35,28,53,254.7898109,8.289473684,2112.073432,117.3374129,0.08492994
2.080869066,92,64,64,27,5,17,12,70.66261466,9,22,20,39,31,59,292.2975823,7.977272727,2331.737532,129.540974,0.09743253
2.080869066,91,63,67,2,6,16,13,60.41568547,9,27,22,42,36,64,330.8752,7,2316.126401,128.6736889,0.110291733
2.080869066,90,64,64,24,5,17,12,70.7915402,9,19,18,35,28,53,254.7898109,8.289473684,2112.073432,117.3374129,0.08492994
2.054153908,104,73,76,24,5,20,15,66.83114483,9,28,28,53,37,81,421.9657226,8.517857143,3594.243744,199.680208,0.140655241
1.955341586,129,86,89,20,4,25,19,58.95448124,12,76,70,137,88,207,1337.102345,10.81578947,14461.81747,803.4343038,0.445700782
1.953817844,87,58,63,19,5,16,13,69.8828062,8,24,24,45,32,69,345,7.5,2587.5,143.75,0.115
1.953817844,72,49,52,5,4,16,6,68.9054745,8,17,12,23,25,35,162.5349666,5.411764706,879.6009959,48.866722,0.054178322
1.953817844,75,47,52,9,6,15,9,72.56032848,7,19,13,26,26,39,183.317149,4.789473684,877.992661,48.77737006,0.061105716
1.953817844,95,52,56,5,13,21,16,69.1687478,9,29,25,48,38,73,383.0987085,7.448275862,2853.424863,158.5236035,0.127699569
1.953817844,98,62,67,10,7,18,16,65.61360451,8,26,28,52,34,80,406.9970273,8,3255.976218,180.8875677,0.135665676
1.953817844,95,69,68,8,4,19,16,61.2385646,11,30,30,58,41,88,471.4645764,10.63333333,5013.239996,278.5133331,0.157154859
1.953817844,95,66,69,20,5,18,13,68.37823045,8,24,24,45,32,69,345,7.5,2587.5,143.75,0.115
1.942667314,81,56,57,15,7,15,9,71.14621693,9,27,21,39,36,60,310.1955001,6.5,2016.270751,112.0150417,0.1033985
1.942257808,65,44,45,10,6,13,5,75.52496489,7,19,12,22,26,34,159.8149504,4.052631579,647.671115,35.9817286,0.05327165
1.942257808,91,63,66,15,4,19,10,68.31097316,10,28,19,35,38,54,283.3880857,6.25,1771.17554,98.39864088,0.0944627
1.942257808,65,44,45,10,6,13,5,75.52496489,7,19,12,22,26,34,159.8149504,4.052631579,647.671115,35.9817286,0.05327165
1.942257808,94,66,69,16,4,19,11,67.40165712,10,31,21,39,41,60,321.45312,6.290322581,2022.043821,112.3357678,0.10715104
1.914214999,63,44,45,8,4,13,8,72.13923365,9,18,16,31,27,47,223.4797126,7.75,1731.967773,96.22043181,0.07449324
1.914214999,68,46,47,14,5,14,8,73.32725873,9,25,21,41,34,62,315.4226962,7.38,2327.819498,129.3233054,0.105140899
2.58786049,125,88,91,9,4,23,23,52.90112061,14,77,74,145,91,219,1425.207026,13.18181818,18786.81989,1043.712216,0.475069009
2.566138296,97,72,73,17,6,14,14,65.95688665,11,30,27,51,41,78,417.8890564,9.35,3907.262677,217.0701487,0.139296352
2.565706609,124,85,85,38,4,24,19,63.89461769,12,51,47,89,63,136,812.9100696,10.47058824,8511.646611,472.8692562,0.270970023
2.516309726,91,63,62,18,4,20,13,68.21273161,10,30,26,50,40,76,404.4665352,8.333333333,3370.55446,187.2530256,0.134822178
2.516309726,88,58,59,16,4,20,13,68.71614684,10,30,26,50,40,76,404.4665352,8.333333333,3370.55446,187.2530256,0.134822178
2.516309726,98,67,66,23,5,20,14,68.02324661,10,33,29,56,43,85,461.2325041,8.484848485,3913.487914,217.4159952,0.153744168
2.516309726,93,62,62,17,4,22,13,68.07926053,10,30,26,50,40,76,404.4665352,8.333333333,3370.55446,187.2530256,0.134822178
2.516309726,93,67,67,8,4,18,15,61.71593127,10,34,30,58,44,88,480.4299824,8.529411765,4097.785144,227.6547302,0.160143327
2.516309726,89,60,61,19,4,19,13,68.34430831,10,37,31,60,47,91,505.4675855,8.108108108,4098.385828,227.6881016,0.1684892
2.516309726,94,61,62,20,4,22,13,68.5359569,11,36,29,56,47,85,472.1400524,8.555555556,4039.420448,224.4122471,0.157380017
2.516309726,91,62,61,17,4,21,13,68.18064846,10,30,26,50,40,76,404.4665352,8.333333333,3370.55446,187.2530256,0.134822178
2.516309726,92,64,68,12,3,17,14,64.10122308,11,34,29,55,45,84,461.3156601,8.897058824,4104.352564,228.0195869,0.153771887
2.516309726,105,78,78,12,4,19,16,60.46655049,12,44,37,70,56,107,621.3869767,9.545454545,5931.421141,329.5233967,0.207128992
2.516309726,116,83,84,8,7,21,10.5,58.8702613,10,35,31,60,45,91,499.7586318,8.571428571,4283.645415,237.9803008,0.166586211
2.378423025,81,57,57,8,4,16,10,66.87941607,8,24,19,37,32,56,280,6.166666667,1726.666667,95.92592593,0.09333333
2.175165626,89,59,60,16,4,20,13,68.13896941,10,34,28,54,44,82,447.6733927,7.941176471,3555.053413,197.502967,0.149224464
2.098868102,98,68,69,18,4,18,12,65.6683711,11,43,36,71,54,107,615.7729627,9.081395349,5592.07772,310.6709844,0.205257654
2.080869066,90,64,64,24,5,17,12,70.7915402,9,19,18,35,28,53,254.7898109,8.289473684,2112.073432,117.3374129,0.08492994
2.080869066,92,64,64,27,5,17,12,70.66261466,9,22,20,39,31,59,292.2975823,7.977272727,2331.737532,129.540974,0.09743253
2.080869066,91,63,67,2,6,16,13,60.41568547,9,27,22,42,36,64,330.8752,7,2316.126401,128.6736889,0.110291733
2.080869066,90,64,64,24,5,17,12,70.7915402,9,19,18,35,28,53,254.7898109,8.289473684,2112.073432,117.3374129,0.08492994
2.080869066,87,63,64,5,6,14,12,63.87575636,9,22,20,39,31,59,292.2975823,7.977272727,2331.737532,129.540974,0.09743253
2.080869066,88,63,63,21,5,17,12,70.55665236,9,19,18,35,28,53,254.7898109,8.289473684,2112.073432,117.3374129,0.08492994
2.080869066,105,76,76,29,5,19,14,67.0606149,11,33,29,55,44,84,458.592256,9.166666667,4203.762346,233.5423526,0.152864085
2.080869066,95,67,67,29,5,17,13,69.7507462,9,25,22,43,34,65,330.6850847,7.74,2559.502555,142.194586,0.110228362
2.58786049,125,88,91,9,4,23,23,52.90112061,14,77,74,145,91,219,1425.207026,13.18181818,18786.81989,1043.712216,0.475069009
2.58786049,132,93,96,15,4,25,24,54.56759786,14,86,81,159,100,240,1594.525486,12.94186047,20636.12634,1146.451463,0.531508495
2.566138296,97,72,73,17,6,14,14,65.95688665,11,30,27,51,41,78,417.8890564,9.35,3907.262677,217.0701487,0.139296352
2.565706609,124,85,85,38,4,24,19,63.89461769,12,51,47,89,63,136,812.9100696,10.47058824,8511.646611,472.8692562,0.270970023
2.565706609,124,85,85,38,4,24,19,63.89461769,12,51,47,89,63,136,812.9100696,10.47058824,8511.646611,472.8692562,0.270970023
2.565706609,122,85,85,30,4,24,19,63.10028078,12,51,47,89,63,136,812.9100696,10.47058824,8511.646611,472.8692562,0.270970023
2.565706609,124,85,85,38,4,24,19,63.82826737,12,51,48,91,63,139,830.8419094,10.70588235,8894.895736,494.1608742,0.276947303
2.516309726,91,63,62,18,4,20,13,68.21273161,10,30,26,50,40,76,404.4665352,8.333333333,3370.55446,187.2530256,0.134822178
2.516309726,88,58,59,16,4,20,13,68.71614684,10,30,26,50,40,76,404.4665352,8.333333333,3370.55446,187.2530256,0.134822178
2.516309726,98,67,66,23,5,20,14,68.02324661,10,33,29,56,43,85,461.2325041,8.484848485,3913.487914,217.4159952,0.153744168
2.516309726,93,62,62,17,4,22,13,68.07926053,10,30,26,50,40,76,404.4665352,8.333333333,3370.55446,187.2530256,0.134822178
2.516309726,93,67,67,8,4,18,15,61.71593127,10,34,30,58,44,88,480.4299824,8.529411765,4097.785144,227.6547302,0.160143327
2.516309726,89,60,61,19,4,19,13,68.34430831,10,37,31,60,47,91,505.4675855,8.108108108,4098.385828,227.6881016,0.1684892
2.516309726,94,61,62,20,4,22,13,68.5359569,11,36,29,56,47,85,472.1400524,8.555555556,4039.420448,224.4122471,0.157380017
2.516309726,91,62,61,17,4,21,13,68.18064846,10,30,26,50,40,76,404.4665352,8.333333333,3370.55446,187.2530256,0.134822178
2.516309726,92,64,68,12,3,17,14,64.10122308,11,34,29,55,45,84,461.3156601,8.897058824,4104.352564,228.0195869,0.153771887
2.516309726,105,78,78,12,4,19,16,60.46655049,12,44,37,70,56,107,621.3869767,9.545454545,5931.421141,329.5233967,0.207128992
2.516309726,116,83,84,8,7,21,10.5,58.8702613,10,35,31,60,45,91,499.7586318,8.571428571,4283.645415,237.9803008,0.166586211
2.516309726,89,60,61,19,4,19,13,68.34430831,10,37,31,60,47,91,505.4675855,8.108108108,4098.385828,227.6881016,0.1684892
2.516309726,98,70,70,11,4,19,17,61.81023984,11,40,36,70,51,106,601.2770862,9.625,5787.291955,321.5162197,0.200425695
2.516309726,97,67,66,22,4,21,14,67.6740946,10,33,29,56,43,85,461.2325041,8.484848485,3913.487914,217.4159952,0.153744168
2.516309726,113,80,81,8,7,21,10.5,59.51704197,10,35,31,60,45,91,499.7586318,8.571428571,4283.645415,237.9803008,0.166586211
2.516309726,102,66,67,25,4,23,15,67.67484099,11,40,32,62,51,94,533.2079821,8.525,4545.598048,252.5332249,0.177735994
2.516309726,108,78,78,16,5,19,16,62.60128831,12,44,37,70,56,107,621.3869767,9.545454545,5931.421141,329.5233967,0.207128992
2.516309726,93,65,64,20,4,20,14,67.62934338,10,33,30,57,43,87,472.0850337,8.636363636,4077.098018,226.5054454,0.157361678
2.58786049,125,88,91,9,4,23,23,52.90112061,14,77,74,145,91,219,1425.207026,13.18181818,18786.81989,1043.712216,0.475069009
2.58786049,132,93,96,15,4,25,24,54.56759786,14,86,81,159,100,240,1594.525486,12.94186047,20636.12634,1146.451463,0.531508495
2.58786049,148,104,107,20,5,27,28,53.85559733,14,97,92,180,111,272,1848.081116,12.98969072,24006.00212,1333.666784,0.616027039
2.58786049,168,120,124,16,7,27,17,50.0958116,14,92,89,174,106,263,1769.44308,13.23913043,23425.88773,1301.438207,0.58981436
2.584754046,138,93,93,47,4,27,21,62.47036411,12,60,53,101,72,154,950.1684502,10.1,9596.701347,533.150075,0.316722817
2.584754046,133,90,90,45,4,25,21,62.78464662,12,59,53,101,71,154,947.0610564,10.27118644,9727.440681,540.4133712,0.315687019
2.584754046,188,129,133,38,8,33,17,53.67726049,13,114,99,191,127,290,2026.718559,10.89035088,22071.67624,1226.204235,0.675572853
2.566138296,97,72,73,17,6,14,14,65.95688665,11,30,27,51,41,78,417.8890564,9.35,3907.262677,217.0701487,0.139296352
2.565706609,124,85,85,38,4,24,19,63.89461769,12,51,47,89,63,136,812.9100696,10.47058824,8511.646611,472.8692562,0.270970023
2.565706609,124,85,85,38,4,24,19,63.89461769,12,51,47,89,63,136,812.9100696,10.47058824,8511.646611,472.8692562,0.270970023
2.565706609,122,85,85,30,4,24,19,63.10028078,12,51,47,89,63,136,812.9100696,10.47058824,8511.646611,472.8692562,0.270970023
2.565706609,124,85,85,38,4,24,19,63.82826737,12,51,48,91,63,139,830.8419094,10.70588235,8894.895736,494.1608742,0.276947303
2.565706609,142,102,103,33,7,23,23,60.51987825,12,54,49,93,66,142,858.3039649,10.33333333,8869.140971,492.730054,0.286101322
2.565706609,136,99,100,13,7,22,13,55.80951055,12,54,49,93,66,142,858.3039649,10.33333333,8869.140971,492.730054,0.286101322
2.565706609,126,87,87,40,4,24,20,63.46109044,12,51,49,93,63,142,848.7737491,10.94117647,9286.583373,515.921298,0.282924583
2.565706609,124,85,85,37,4,24,19,63.76569762,12,51,48,91,63,139,830.8419094,10.70588235,8894.895736,494.1608742,0.276947303
2.565706609,127,86,86,40,4,24,19,63.7816967,12,52,48,91,64,139,834,10.5,8757,486.5,0.278
2.565706609,128,87,87,40,4,25,20,63.42713642,12,54,49,93,66,142,858.3039649,10.33333333,8869.140971,492.730054,0.286101322
2.565706609,122,85,85,30,4,24,19,63.10028078,12,51,47,89,63,136,812.9100696,10.47058824,8511.646611,472.8692562,0.270970023
2.516309726,91,63,62,18,4,20,13,68.21273161,10,30,26,50,40,76,404.4665352,8.333333333,3370.55446,187.2530256,0.134822178
2.516309726,88,58,59,16,4,20,13,68.71614684,10,30,26,50,40,76,404.4665352,8.333333333,3370.55446,187.2530256,0.134822178
2.516309726,98,67,66,23,5,20,14,68.02324661,10,33,29,56,43,85,461.2325041,8.484848485,3913.487914,217.4159952,0.153744168
2.516309726,93,62,62,17,4,22,13,68.07926053,10,30,26,50,40,76,404.4665352,8.333333333,3370.55446,187.2530256,0.134822178
2.516309726,93,67,67,8,4,18,15,61.71593127,10,34,30,58,44,88,480.4299824,8.529411765,4097.785144,227.6547302,0.160143327
2.516309726,89,60,61,19,4,19,13,68.34430831,10,37,31,60,47,91,505.4675855,8.108108108,4098.385828,227.6881016,0.1684892
2.838843048,139,96,96,43,4,25,24,61.15299165,13,68,59,113,81,172,1090.4542,10.80147059,11778.50897,654.3616097,0.363484733
2.641138504,142,100,103,19,4,27,26,54.3031901,14,96,87,171,110,258,1749.590806,12.46875,21815.21036,1211.956131,0.583196935
2.593179423,176,119,121,19,11,33,9,55.09534139,12,68,59,111,80,170,1074.727776,9.794117647,10526.01028,584.778349,0.358242592
2.58786049,125,88,91,9,4,23,23,52.90112061,14,77,74,145,91,219,1425.207026,13.18181818,18786.81989,1043.712216,0.475069009
2.58786049,132,93,96,15,4,25,24,54.56759786,14,86,81,159,100,240,1594.525486,12.94186047,20636.12634,1146.451463,0.531508495
2.58786049,148,104,107,20,5,27,28,53.85559733,14,97,92,180,111,272,1848.081116,12.98969072,24006.00212,1333.666784,0.616027039
2.58786049,168,120,124,16,7,27,17,50.0958116,14,92,89,174,106,263,1769.44308,13.23913043,23425.88773,1301.438207,0.58981436
2.58786049,140,98,101,13,4,26,26,52.482856,14,85,81,159,99,240,1591.045589,13.09411765,20833.33812,1157.407673,0.53034853
2.58786049,152,106,109,23,5,28,28,54.33414427,14,99,94,184,113,278,1896.009752,13.01010101,24667.27838,1370.404355,0.632003251
2.58786049,150,106,109,20,5,27,28,53.52861247,14,97,92,180,111,272,1848.081116,12.98969072,24006.00212,1333.666784,0.616027039
2.58786049,164,116,119,25,5,30,34,51.92001177,14,112,112,220,126,332,2316.456935,13.75,31851.28285,1769.515714,0.772152312
2.58786049,165,117,121,16,7,27,16.5,50.70542587,14,92,88,172,106,260,1749.259318,13.08695652,22892.48064,1271.80448,0.583086439
2.584754046,138,93,93,47,4,27,21,62.47036411,12,60,53,101,72,154,950.1684502,10.1,9596.701347,533.150075,0.316722817
2.584754046,133,90,90,45,4,25,21,62.78464662,12,59,53,101,71,154,947.0610564,10.27118644,9727.440681,540.4133712,0.315687019
2.584754046,188,129,133,38,8,33,17,53.67726049,13,114,99,191,127,290,2026.718559,10.89035088,22071.67624,1226.204235,0.675572853
2.584754046,145,97,97,50,4,28,23,61.34141058,13,68,60,115,81,175,1109.473751,10.99264706,12196.05336,677.55852,0.369824584
2.584754046,138,93,93,47,4,27,21,62.47036411,12,60,53,101,72,154,950.1684502,10.1,9596.701347,533.150075,0.316722817
2.584754046,195,139,141,34,7,33,18.5,51.29813304,14,110,103,199,124,302,2100.167286,12.66363636,26595.75481,1477.541934,0.700055762
2.584754046,188,129,133,38,8,33,17,53.67726049,13,114,99,191,127,290,2026.718559,10.89035088,22071.67624,1226.204235,0.675572853
2.584754046,190,131,135,38,8,33,17,53.49077298,13,110,98,189,123,287,1992.501663,11.16818182,22252.62085,1236.25671,0.664167221
2.584754046,151,107,108,42,7,25,24,60.24215016,12,61,54,103,73,157,971.8024557,10.13114754,9845.47406,546.9707811,0.323934152
2.584754046,191,132,135,40,8,34,17,53.62652399,13,114,99,191,127,290,2026.718559,10.89035088,22071.67624,1226.204235,0.675572853
2.584754046,190,132,135,39,8,33,17,53.499753,13,114,99,191,127,290,2026.718559,10.89035088,22071.67624,1226.204235,0.675572853
2.584754046,195,134,138,41,8,34,18.5,53.05621143,13,111,100,193,124,293,2037.579519,11.3018018,23028.31988,1279.351104,0.679193173
2.584754046,133,90,90,45,4,25,21,62.78464662,12,59,53,101,71,154,947.0610564,10.27118644,9727.440681,540.4133712,0.315687019
2.838843048,139,96,96,43,4,25,24,61.15299165,13,68,59,113,81,172,1090.4542,10.80147059,11778.50897,654.3616097,0.363484733
2.671054276,137,92,92,46,4,26,23,61.96575789,13,64,58,111,77,169,1059.086925,11.2734375,11939.55026,663.3083478,0.353028975
2.652658648,176,120,124,28,7,30,15.5,53.46905107,14,106,97,189,120,286,1975.37071,12.48113208,24654.86273,1369.714596,0.658456903
2.641138504,142,100,103,19,4,27,26,54.3031901,14,96,87,171,110,258,1749.590806,12.46875,21815.21036,1211.956131,0.583196935
2.641138504,158,111,114,24,5,29,30,53.38161069,14,107,98,192,121,290,2006.470339,12.56074766,25202.76762,1400.153757,0.668823446
2.641138504,154,109,112,22,5,28,28,53.67311073,14,100,91,178,114,269,1838.047414,12.46,22902.07078,1272.337265,0.612682471
2.593179423,176,119,121,19,11,33,9,55.09534139,12,68,59,111,80,170,1074.727776,9.794117647,10526.01028,584.778349,0.358242592
2.58786049,125,88,91,9,4,23,23,52.90112061,14,77,74,145,91,219,1425.207026,13.18181818,18786.81989,1043.712216,0.475069009
2.58786049,132,93,96,15,4,25,24,54.56759786,14,86,81,159,100,240,1594.525486,12.94186047,20636.12634,1146.451463,0.531508495
2.58786049,148,104,107,20,5,27,28,53.85559733,14,97,92,180,111,272,1848.081116,12.98969072,24006.00212,1333.666784,0.616027039
2.58786049,168,120,124,16,7,27,17,50.0958116,14,92,89,174,106,263,1769.44308,13.23913043,23425.88773,1301.438207,0.58981436
2.58786049,140,98,101,13,4,26,26,52.482856,14,85,81,159,99,240,1591.045589,13.09411765,20833.33812,1157.407673,0.53034853
2.58786049,152,106,109,23,5,28,28,54.33414427,14,99,94,184,113,278,1896.009752,13.01010101,24667.27838,1370.404355,0.632003251
2.58786049,150,106,109,20,5,27,28,53.52861247,14,97,92,180,111,272,1848.081116,12.98969072,24006.00212,1333.666784,0.616027039
2.58786049,164,116,119,25,5,30,34,51.92001177,14,112,112,220,126,332,2316.456935,13.75,31851.28285,1769.515714,0.772152312
2.58786049,165,117,121,16,7,27,16.5,50.70542587,14,92,88,172,106,260,1749.259318,13.08695652,22892.48064,1271.80448,0.583086439
2.58786049,180,132,135,27,5,30,34,49.58454956,14,135,133,262,149,395,2851.571566,13.58518519,38739.12779,2152.173766,0.950523855
2.58786049,156,109,112,25,5,28,29,54.06434391,14,104,99,194,118,293,2016.614413,13.05769231,26332.33051,1462.907251,0.672204804
2.58786049,164,116,119,25,5,30,34,51.92001177,14,112,112,220,126,332,2316.456935,13.75,31851.28285,1769.515714,0.772152312
2.58786049,172,122,126,18,7,28,17.5,50.31445713,14,93,90,176,107,266,1793.230218,13.24731183,23755.47988,1319.748882,0.597743406
2.58786049,145,100,103,15,4,28,26,52.9110595,14,88,84,165,102,249,1661.43391,13.125,21806.32007,1211.462226,0.5538113
2.58786049,168,120,123,27,5,30,34,51.58881491,14,120,120,236,134,356,2515.527752,13.76666667,34630.43205,1923.912892,0.83850925
2.587421465,200,134,136,55,4,38,36,53.60013646,14,118,115,223,132,338,2381.005212,13.22881356,31497.87404,1749.881891,0.793668404
2.585192167,152,107,110,24,5,27,28,54.52668489,14,106,90,177,120,267,1844.139789,11.68867925,21555.55848,1197.531027,0.614713263
2.584754046,138,93,93,47,4,27,21,62.47036411,12,60,53,101,72,154,950.1684502,10.1,9596.701347,533.150075,0.316722817
3.218623148,139,96,96,44,4,25,24,60.9740227,13,73,63,120,86,183,1176.00645,10.68493151,12565.54837,698.0860206,0.39200215
3.218623148,186,130,133,25,3,34,35,49.45982268,14,118,106,204,132,310,2183.762177,12.10169492,26427.22363,1468.179091,0.727920726
2.838843048,139,96,96,43,4,25,24,61.15299165,13,68,59,113,81,172,1090.4542,10.80147059,11778.50897,654.3616097,0.363484733
2.725657111,154,104,104,52,4,29,26,59.92762447,13,77,65,125,90,190,1233.452088,10.55194805,13015.32236,723.0734645,0.411150696
2.671054276,137,92,92,46,4,26,23,61.96575789,13,64,58,111,77,169,1059.086925,11.2734375,11939.55026,663.3083478,0.353028975
2.671054276,186,130,132,41,4,31,35,52.67024286,15,124,117,227,139,344,2448.915729,13.72983871,33623.21797,1867.956554,0.816305243
2.652658648,176,120,124,28,7,30,15.5,53.46905107,14,106,97,189,120,286,1975.37071,12.48113208,24654.86273,1369.714596,0.658456903
2.65071869,145,99,99,46,4,27,23,60.63883708,13,78,66,127,91,193,1256.004366,10.58333333,13292.71287,738.484048,0.418668122
2.65071869,143,99,99,46,4,25,24,60.82139389,13,69,61,117,82,178,1131.644257,11.02173913,12472.68779,692.9270993,0.377214752
2.650265009,183,125,129,31,7,31,16.5,52.58850912,15,121,113,219,136,332,2353.037663,13.57438017,31941.02778,1774.501544,0.784345888
2.641138504,142,100,103,19,4,27,26,54.3031901,14,96,87,171,110,258,1749.590806,12.46875,21815.21036,1211.956131,0.583196935
2.641138504,158,111,114,24,5,29,30,53.38161069,14,107,98,192,121,290,2006.470339,12.56074766,25202.76762,1400.153757,0.668823446
2.641138504,154,109,112,22,5,28,28,53.67311073,14,100,91,178,114,269,1838.047414,12.46,22902.07078,1272.337265,0.612682471
2.641138504,162,113,116,25,5,30,32,52.7972638,14,113,106,208,127,314,2194.446992,12.88495575,28275.35239,1570.85291,0.731482331
2.641138504,160,115,118,25,5,28,29,53.30453389,14,101,95,186,115,281,1923.582704,12.89108911,24797.07605,1377.615336,0.641194235
2.641138504,190,139,142,31,6,31,36,49.3830077,14,145,139,274,159,413,3020.220661,13.22758621,39950.22915,2219.457175,1.00674022
2.641138504,171,125,128,9,4,31,32,44.68425196,14,103,97,190,117,287,1971.794675,12.91262136,25461.03803,1414.502113,0.657264892
2.627404396,169,119,122,28,5,30,33,52.41040876,14,116,109,214,130,323,2268.224804,12.9137931,29291.38583,1627.299213,0.756074935
2.593179423,176,119,121,19,11,33,9,55.09534139,12,68,59,111,80,170,1074.727776,9.794117647,10526.01028,584.778349,0.358242592
2.58786049,125,88,91,9,4,23,23,52.90112061,14,77,74,145,91,219,1425.207026,13.18181818,18786.81989,1043.712216,0.475069009
2.58786049,132,93,96,15,4,25,24,54.56759786,14,86,81,159,100,240,1594.525486,12.94186047,20636.12634,1146.451463,0.531508495
2.58786049,148,104,107,20,5,27,28,53.85559733,14,97,92,180,111,272,1848.081116,12.98969072,24006.00212,1333.666784,0.616027039
2.58786049,168,120,124,16,7,27,17,50.0958116,14,92,89,174,106,263,1769.44308,13.23913043,23425.88773,1301.438207,0.58981436
2.58786049,140,98,101,13,4,26,26,52.482856,14,85,81,159,99,240,1591.045589,13.09411765,20833.33812,1157.407673,0.53034853
2.58786049,152,106,109,23,5,28,28,54.33414427,14,99,94,184,113,278,1896.009752,13.01010101,24667.27838,1370.404355,0.632003251
3.283998689,198,137,140,26,3,36,39,47.928359,15,130,117,226,145,343,2462.708818,13.03846154,32109.9342,1783.885233,0.820902939
3.218623148,139,96,96,44,4,25,24,60.9740227,13,73,63,120,86,183,1176.00645,10.68493151,12565.54837,698.0860206,0.39200215
3.218623148,186,130,133,25,3,34,35,49.45982268,14,118,106,204,132,310,2183.762177,12.10169492,26427.22363,1468.179091,0.727920726
2.838843048,139,96,96,43,4,25,24,61.15299165,13,68,59,113,81,172,1090.4542,10.80147059,11778.50897,654.3616097,0.363484733
2.811591846,259,174,175,45,14,45,11,48.41251518,15,149,140,268,164,408,3001.881218,13.48993289,40495.17616,2249.732009,1.000627073
2.738844955,180,122,126,31,7,31,16,53.54606224,14,108,100,195,122,295,2044.567515,12.63888889,25841.06164,1435.614536,0.681522505
2.725657111,154,104,104,52,4,29,26,59.92762447,13,77,65,125,90,190,1233.452088,10.55194805,13015.32236,723.0734645,0.411150696
2.725657111,194,133,136,54,5,35,34,53.90795627,15,137,113,219,152,332,2406.311934,11.98905109,28849.39673,1602.744263,0.802103978
2.725657111,154,104,104,52,4,29,27,59.6693313,14,80,67,129,94,196,1284.699415,11.2875,14501.04465,805.6135914,0.428233138
2.671054276,137,92,92,46,4,26,23,61.96575789,13,64,58,111,77,169,1059.086925,11.2734375,11939.55026,663.3083478,0.353028975
2.671054276,186,130,132,41,4,31,35,52.67024286,15,124,117,227,139,344,2448.915729,13.72983871,33623.21797,1867.956554,0.816305243
2.671054276,137,92,92,46,4,26,23,61.96575789,13,64,58,111,77,169,1059.086925,11.2734375,11939.55026,663.3083478,0.353028975
2.652658648,176,120,124,28,7,30,15.5,53.46905107,14,106,97,189,120,286,1975.37071,12.48113208,24654.86273,1369.714596,0.658456903
2.652658648,183,125,129,31,7,31,16.5,52.89457456,14,108,104,203,122,307,2127.736363,13.15740741,27995.49418,1555.305232,0.70924545
2.652658648,188,127,131,30,7,34,17,52.3569902,14,110,102,199,124,301,2093.213089,12.66363636,26507.6894,1472.649411,0.697737696
2.65071869,145,99,99,46,4,27,23,60.63883708,13,78,66,127,91,193,1256.004366,10.58333333,13292.71287,738.484048,0.418668122
2.65071869,143,99,99,46,4,25,24,60.82139389,13,69,61,117,82,178,1131.644257,11.02173913,12472.68779,692.9270993,0.377214752
2.65071869,145,99,99,46,4,27,23,60.63883708,13,78,66,127,91,193,1256.004366,10.58333333,13292.71287,738.484048,0.418668122
2.65071869,201,142,144,54,4,35,38,51.84282269,14,150,134,261,164,395,2906.233042,12.18,35397.91845,1966.551025,0.968744347
2.65071869,148,101,101,48,4,27,24,60.48706396,13,73,64,123,86,187,1201.711509,10.95205479,13161.2103,731.1783497,0.400570503
2.650265009,183,125,129,31,7,31,16.5,52.58850912,15,121,113,219,136,332,2353.037663,13.57438017,31941.02778,1774.501544,0.784345888
2.641138504,142,100,103,19,4,27,26,54.3031901,14,96,87,171,110,258,1749.590806,12.46875,21815.21036,1211.956131,0.583196935
2.641138504,158,111,114,24,5,29,30,53.38161069,14,107,98,192,121,290,2006.470339,12.56074766,25202.76762,1400.153757,0.668823446
2.641138504,154,109,112,22,5,28,28,53.67311073,14,100,91,178,114,269,1838.047414,12.46,22902.07078,1272.337265,0.612682471
2.641138504,162,113,116,25,5,30,32,52.7972638,14,113,106,208,127,314,2194.446992,12.88495575,28275.35239,1570.85291,0.731482331
3.530443664,184,129,133,28,4,33,29,51.12769395,14,131,115,218,145,333,2390.909727,11.64885496,27851.36064,1547.297813,0.796969909
3.306157608,206,140,143,30,3,38,41,48.08214638,15,140,125,241,155,366,2663.061532,12.91071429,34382.02657,1910.112587,0.887687177
3.283998689,198,137,140,26,3,36,39,47.928359,15,130,117,226,145,343,2462.708818,13.03846154,32109.9342,1783.885233,0.820902939
3.283998689,202,139,142,28,3,36,39,48.15327782,15,132,119,230,147,349,2512.685648,13.06818182,32836.2329,1824.235161,0.837561883
3.225705301,209,142,145,35,3,38,39,49.17054292,15,140,126,244,155,370,2692.16603,13.07142857,35190.45596,1955.025331,0.897388677
3.218623148,139,96,96,44,4,25,24,60.9740227,13,73,63,120,86,183,1176.00645,10.68493151,12565.54837,698.0860206,0.39200215
3.218623148,186,130,133,25,3,34,35,49.45982268,14,118,106,204,132,310,2183.762177,12.10169492,26427.22363,1468.179091,0.727920726
3.218623148,142,99,99,45,4,25,25,60.41057371,13,75,65,124,88,189,1220.832576,10.74666667,13119.88075,728.8822638,0.406944192
3.218623148,140,97,97,45,4,25,24,60.73725129,13,77,66,125,90,191,1239.943941,10.55194805,13083.82406,726.8791143,0.413314647
3.214110906,151,99,106,52,4,26,24,60.71911355,13,75,64,122,88,186,1201.454281,10.57333333,12703.3766,705.7431444,0.40048476
3.154506259,198,137,140,32,3,37,37,49.84699857,14,126,112,216,140,328,2338.40483,12,28060.85795,1558.936553,0.779468277
2.980543918,157,116,116,33,3,28,27,55.35506031,14,100,84,162,114,246,1680.890943,11.34,19061.3033,1058.961294,0.560296981
2.838843048,139,96,96,43,4,25,24,61.15299165,13,68,59,113,81,172,1090.4542,10.80147059,11778.50897,654.3616097,0.363484733
2.821797776,206,140,143,36,3,38,40,49.78921896,15,129,115,223,144,338,2423.43465,12.96511628,31420.11204,1745.56178,0.80781155
2.821797776,158,106,106,53,4,30,29,58.95960594,14,85,72,139,99,211,1398.794247,11.44705882,16012.08003,889.5600014,0.466264749
2.821797776,212,146,148,57,5,38,40,51.69936347,15,145,126,245,160,371,2716.435323,12.67241379,34423.7925,1912.43291,0.905478441
2.811591846,259,174,175,45,14,45,11,48.41251518,15,149,140,268,164,408,3001.881218,13.48993289,40495.17616,2249.732009,1.000627073
2.738844955,180,122,126,31,7,31,16,53.54606224,14,108,100,195,122,295,2044.567515,12.63888889,25841.06164,1435.614536,0.681522505
2.738844955,180,122,126,31,7,31,16,53.54606224,14,108,100,195,122,295,2044.567515,12.63888889,25841.06164,1435.614536,0.681522505
2.735101323,192,127,131,35,7,36,15.5,53.24407365,14,122,114,223,136,337,2388.474978,12.79508197,30560.73311,1697.818506,0.796158326
2.730209571,230,159,162,47,7,38,22,48.8884098,16,150,141,271,166,412,3038.516246,14.45333333,43916.6881,2439.816008,1.012838749
2.725657111,154,104,104,52,4,29,26,59.92762447,13,77,65,125,90,190,1233.452088,10.55194805,13015.32236,723.0734645,0.411150696
2.725657111,194,133,136,54,5,35,34,53.90795627,15,137,113,219,152,332,2406.311934,11.98905109,28849.39673,1602.744263,0.802103978
2.725657111,154,104,104,52,4,29,27,59.6693313,14,80,67,129,94,196,1284.699415,11.2875,14501.04465,805.6135914,0.428233138
2.725657111,154,104,104,52,4,29,26,59.92762447,13,77,65,125,90,190,1233.452088,10.55194805,13015.32236,723.0734645,0.411150696
3.938397811,231,151,154,46,5,45,40,49.23914194,15,184,161,308,199,469,3581.576947,12.55434783,44964.36276,2498.020153,1.193858982
3.530443664,184,129,133,28,4,33,29,51.12769395,14,131,115,218,145,333,2390.909727,11.64885496,27851.36064,1547.297813,0.796969909
3.466272833,194,140,143,29,3,30,36,48.49784656,14,142,126,241,156,367,2673.742614,11.88028169,31764.81543,1764.711968,0.891247538
3.466272833,227,156,159,36,3,40,47,46.28898206,15,160,141,272,175,413,3077.350189,12.75,39236.21491,2179.789717,1.025783396
3.439862391,189,131,135,30,4,35,30,51.14365016,14,132,117,222,146,339,2437.350525,11.77272727,28694.263,1594.125722,0.81245018
3.34864746,200,133,143,33,3,34,35,50.40974275,15,128,113,218,143,331,2369.917412,12.7734375,30271.99195,1681.77733,0.789972471
3.310846129,216,146,149,33,3,41,47,46.88228935,15,151,138,268,166,406,2994.266009,13.31125828,39857.4482,2214.302678,0.99808867
3.306157608,206,140,143,30,3,38,41,48.08214638,15,140,125,241,155,366,2663.061532,12.91071429,34382.02657,1910.112587,0.887687177
3.306157608,199,136,139,28,3,37,38,48.59274189,15,135,122,234,150,356,2573.459454,13,33454.9729,1858.609606,0.857819818
3.283998689,198,137,140,26,3,36,39,47.928359,15,130,117,226,145,343,2462.708818,13.03846154,32109.9342,1783.885233,0.820902939
3.283998689,202,139,142,28,3,36,39,48.15327782,15,132,119,230,147,349,2512.685648,13.06818182,32836.2329,1824.235161,0.837561883
3.283998689,202,139,142,28,3,36,40,47.95465378,15,135,121,234,150,355,2566.230635,13,33360.99826,1853.388792,0.855410212
3.278363575,199,130,140,40,3,36,35,52.22248493,15,122,109,210,137,319,2264.272234,12.90983607,29231.38335,1623.96574,0.75475741
3.23912946,142,98,98,45,4,25,24,60.56283896,13,78,67,127,91,194,1262.51216,10.58333333,13361.58703,742.3103905,0.42083739
3.225705301,209,142,145,35,3,38,39,49.17054292,15,140,126,244,155,370,2692.16603,13.07142857,35190.45596,1955.025331,0.897388677
3.225705301,210,143,146,34,3,39,41,48.55083357,15,141,127,246,156,373,2717.455028,13.08510638,35558.18813,1975.454896,0.905818343
3.225705301,214,142,145,35,5,41,39,49.55418389,15,140,126,244,155,370,2692.16603,13.07142857,35190.45596,1955.025331,0.897388677
3.225705301,223,152,155,37,3,40,44,47.2956961,15,155,143,277,170,420,3111.944193,13.40322581,41710.0907,2317.227262,1.037314731
3.225705301,223,152,155,37,3,40,44,47.2956961,15,155,143,277,170,420,3111.944193,13.40322581,41710.0907,2317.227262,1.037314731
3.218623148,139,96,96,44,4,25,24,60.9740227,13,73,63,120,86,183,1176.00645,10.68493151,12565.54837,698.0860206,0.39200215
3.218623148,186,130,133,25,3,34,35,49.45982268,14,118,106,204,132,310,2183.762177,12.10169492,26427.22363,1468.179091,0.727920726
3.218623148,142,99,99,45,4,25,25,60.41057371,13,75,65,124,88,189,1220.832576,10.74666667,13119.88075,728.8822638,0.406944192
3.218623148,140,97,97,45,4,25,24,60.73725129,13,77,66,125,90,191,1239.943941,10.55194805,13083.82406,726.8791143,0.413314647
3.218623148,186,130,133,23,3,34,35,48.85810371,14,118,106,204,132,310,2183.762177,12.10169492,26427.22363,1468.179091,0.727920726
3.218623148,188,131,134,27,3,34,35,49.84248921,14,120,107,206,134,313,2211.685917,12.01666667,26577.09243,1476.505135,0.737228639
3.938397811,231,151,154,46,5,45,40,49.23914194,15,184,161,308,199,469,3581.576947,12.55434783,44964.36276,2498.020153,1.193858982
3.467732614,184,129,133,28,4,33,29,51.12769395,14,131,115,218,145,333,2390.909727,11.64885496,27851.36064,1547.297813,0.796969909
3.547553929,194,140,143,29,3,30,36,48.49784656,14,142,126,241,156,367,2673.742614,11.88028169,31764.81543,1764.711968,0.891247538
3.547553929,227,156,159,36,3,40,47,46.28898206,15,160,141,272,175,413,3077.350189,12.75,39236.21491,2179.789717,1.025783396
3.4259447,189,131,135,30,4,35,30,51.14365016,14,132,117,222,146,339,2437.350525,11.77272727,28694.263,1594.125722,0.81245018
3.34864746,200,133,143,33,3,34,35,50.40974275,15,128,113,218,143,331,2369.917412,12.7734375,30271.99195,1681.77733,0.789972471
3.310846129,216,146,149,33,3,41,47,46.88228935,15,151,138,268,166,406,2994.266009,13.31125828,39857.4482,2214.302678,0.99808867
3.306157608,206,140,143,30,3,38,41,48.08214638,15,140,125,241,155,366,2663.061532,12.91071429,34382.02657,1910.112587,0.887687177
3.306157608,199,136,139,28,3,37,38,48.59274189,15,135,122,234,150,356,2573.459454,13,33454.9729,1858.609606,0.857819818
3.283998689,198,137,140,26,3,36,39,47.928359,15,130,117,226,145,343,2462.708818,13.03846154,32109.9342,1783.885233,0.820902939
3.283998689,202,139,142,28,3,36,39,48.15327782,15,132,119,230,147,349,2512.685648,13.06818182,32836.2329,1824.235161,0.837561883
3.283998689,202,139,142,28,3,36,40,47.95465378,15,135,121,234,150,355,2566.230635,13,33360.99826,1853.388792,0.855410212
3.278363575,199,130,140,40,3,36,35,52.22248493,15,122,109,210,137,319,2264.272234,12.90983607,29231.38335,1623.96574,0.75475741
3.23912946,142,98,98,45,4,25,24,60.56283896,13,78,67,127,91,194,1262.51216,10.58333333,13361.58703,742.3103905,0.42083739
3.225705301,209,142,145,35,3,38,39,49.17054292,15,140,126,244,155,370,2692.16603,13.07142857,35190.45596,1955.025331,0.897388677
3.225705301,210,143,146,34,3,39,41,48.55083357,15,141,127,246,156,373,2717.455028,13.08510638,35558.18813,1975.454896,0.905818343
3.225705301,214,142,145,35,5,41,39,49.55418389,15,140,126,244,155,370,2692.16603,13.07142857,35190.45596,1955.025331,0.897388677
3.225705301,223,152,155,37,3,40,44,47.2956961,15,155,143,277,170,420,3111.944193,13.40322581,41710.0907,2317.227262,1.037314731
3.225705301,223,152,155,37,3,40,44,47.2956961,15,155,143,277,170,420,3111.944193,13.40322581,41710.0907,2317.227262,1.037314731
3.218623148,139,96,96,44,4,25,24,60.9740227,13,73,63,120,86,183,1176.00645,10.68493151,12565.54837,698.0860206,0.39200215
3.218623148,186,130,133,25,3,34,35,49.45982268,14,118,106,204,132,310,2183.762177,12.10169492,26427.22363,1468.179091,0.727920726
3.218623148,142,99,99,45,4,25,25,60.41057371,13,75,65,124,88,189,1220.832576,10.74666667,13119.88075,728.8822638,0.406944192
3.218623148,140,97,97,45,4,25,24,60.73725129,13,77,66,125,90,191,1239.943941,10.55194805,13083.82406,726.8791143,0.413314647
3.218623148,186,130,133,23,3,34,35,48.85810371,14,118,106,204,132,310,2183.762177,12.10169492,26427.22363,1468.179091,0.727920726
3.218623148,188,131,134,27,3,34,35,49.84248921,14,120,107,206,134,313,2211.685917,12.01666667,26577.09243,1476.505135,0.737228639
5.556645379,208,137,147,32,4,36,35,49.76857254,15,133,118,227,148,345,2487.261411,12.80075188,31838.8162,1768.823121,0.829087137
5.40512139,413,276,283,71,9,80,34.5,37.1357328,15,277,248,476,292,724,5929.432981,12.88808664,76419.046,4245.502555,1.97647766
5.385265788,193,135,138,30,3,35,36,49.82538231,14,121,111,214,135,325,2299.96507,12.38016529,28473.94771,1581.885984,0.76665502
5.385265788,358,265,272,48,10,57,32.5,36.18106565,14,257,228,436,271,664,5366.546963,11.87548638,63730.35538,3540.575299,1.788848988
5.207686579,212,144,147,32,3,40,45,47.27297624,14,148,134,260,162,394,2891.900901,12.2972973,35562.56514,1975.698063,0.96396697
4.909598524,197,134,138,58,5,37,31,54.44332703,14,129,116,219,143,335,2398.556898,11.88372093,28503.78081,1583.543378,0.799518966
4.714356928,197,136,140,45,6,34,31,53.07949875,14,134,121,230,148,351,2530.518131,12.01492537,30403.9865,1689.110361,0.843506044
4.359178331,217,147,150,35,3,41,47,47.10390281,15,155,141,274,170,415,3074.897238,13.25806452,40767.18597,2264.843665,1.024965746
4.009690846,231,159,162,40,3,41,47,46.71626045,15,159,141,272,174,413,3073.935664,12.83018868,39439.17455,2191.065253,1.024645221
3.938397811,231,151,154,46,5,45,40,49.23914194,15,184,161,308,199,469,3581.576947,12.55434783,44964.36276,2498.020153,1.193858982
3.938397811,233,152,155,48,5,46,40,49.35987801,15,184,162,310,199,472,3604.486821,12.63586957,45545.82532,2530.323629,1.201495607
3.938397811,229,151,154,39,6,45,39,48.55378558,15,182,160,305,197,465,3544.254096,12.56868132,44546.60025,2474.811125,1.181418032
3.938397811,235,152,155,48,5,47,40,49.25676987,15,189,167,319,204,486,3728.798716,12.65873016,47201.85676,2622.325376,1.242932905
3.938397811,230,151,154,47,5,45,39,49.5293186,15,182,160,305,197,465,3544.254096,12.56868132,44546.60025,2474.811125,1.181418032
3.887175852,385,260,273,47,9,70,34.5,35.6865852,14,242,216,417,256,633,5064,12.06198347,61081.8843,3393.438017,1.688
3.566711544,186,130,134,30,4,33,29,51.4622018,14,132,115,218,146,333,2394.211578,11.56060606,27678.53688,1537.696493,0.798070526
3.547553929,194,140,143,29,3,30,36,48.49784656,14,142,126,241,156,367,2673.742614,11.88028169,31764.81543,1764.711968,0.891247538
3.547553929,227,156,159,36,3,40,47,46.28898206,15,160,141,272,175,413,3077.350189,12.75,39236.21491,2179.789717,1.025783396
3.495336231,194,133,137,33,5,36,30,51.67013282,14,133,119,226,147,345,2483.886959,11.89473684,29545.18172,1641.398985,0.82796232
3.467965012,191,131,135,32,5,35,30,51.78285635,14,132,117,222,146,339,2437.350525,11.77272727,28694.263,1594.125722,0.81245018
3.467732614,184,129,133,28,4,33,29,51.12769395,14,131,115,218,145,333,2390.909727,11.64885496,27851.36064,1547.297813,0.796969909
3.4259447,189,131,135,30,4,35,30,51.14365016,14,132,117,222,146,339,2437.350525,11.77272727,28694.263,1594.125722,0.81245018
3.425711597,192,133,137,32,5,35,30,51.4948701,14,134,118,224,148,342,2465.633051,11.70149254,28851.58675,1602.86593,0.821877684
3.380457011,190,130,134,30,5,35,29,51.66029122,14,131,116,220,145,336,2412.449454,11.75572519,28360.09282,1575.560712,0.804149818
3.34864746,200,133,143,33,3,34,35,50.40974275,15,128,113,218,143,331,2369.917412,12.7734375,30271.99195,1681.77733,0.789972471
5.894375918,234,152,155,48,6,46,40,49.35320602,15,189,168,321,204,489,3751.815992,12.73809524,47790.98942,2655.054968,1.250605331
5.894375918,215,148,158,22,5,38,36,44.7252025,15,195,169,321,210,490,3779.9803,12.34615385,46668.21836,2592.678798,1.259993435
5.678458275,212,148,162,34,6,35,36,48.68271807,15,161,125,241,176,366,2730.151972,11.22670807,30650.61919,1702.812177,0.910050657
5.570815399,229,151,154,34,6,46,38,47.64102367,15,193,168,320,208,488,3757.814582,12.43523316,46729.30051,2596.07225,1.252604861
5.57029068,217,147,150,35,3,41,47,47.0892829,15,155,142,275,170,417,3089.71602,13.30645161,41113.15672,2284.064262,1.02990534
5.57029068,236,152,155,49,6,47,40,49.46099031,15,190,168,321,205,489,3755.265769,12.67105263,47583.1702,2643.509456,1.251755256
5.556645379,208,137,147,32,4,36,35,49.76857254,15,133,118,227,148,345,2487.261411,12.80075188,31838.8162,1768.823121,0.829087137
5.556645379,221,153,163,27,6,35,40,46.09747731,15,151,133,256,166,389,2868.890339,12.71523179,36478.60563,2026.589202,0.95629678
5.556645379,446,291,311,57,9,91,37,33.66878296,15,283,252,487,298,739,6073.965537,12.90636042,78392.78842,4355.154912,2.024655179
5.475318671,342,242,251,47,8,60,25.5,39.72164947,14,236,191,366,250,557,4436.941847,10.8559322,48167.13988,2675.952215,1.478980616
5.410649382,219,142,152,37,6,37,35,50.28935456,15,141,126,242,156,368,2681.028017,12.87234043,34511.10532,1917.283629,0.893676006
5.40512139,413,276,283,71,9,80,34.5,37.1357328,15,277,248,476,292,724,5929.432981,12.88808664,76419.046,4245.502555,1.97647766
5.40512139,259,168,169,49,7,48,41,48.51786944,15,155,143,278,170,421,3119.353584,13.4516129,41960.33692,2331.129829,1.039784528
5.40512139,413,276,283,72,9,80,34.5,37.22402467,15,278,248,476,293,724,5933.003963,12.84172662,76190.0149,4232.778606,1.977667988
5.40512139,413,276,283,72,9,80,34.5,37.19710389,15,279,250,480,294,730,5985.760812,12.90322581,77235.62338,4290.86797,1.995253604
5.40512139,415,278,285,75,9,80,35.5,36.9830554,15,286,256,492,301,748,6158.747518,12.9020979,79460.76343,4414.486857,2.052915839
5.385265788,193,135,138,30,3,35,36,49.82538231,14,121,111,214,135,325,2299.96507,12.38016529,28473.94771,1581.885984,0.76665502
5.385265788,358,265,272,48,10,57,32.5,36.18106565,14,257,228,436,271,664,5366.546963,11.87548638,63730.35538,3540.575299,1.788848988
5.385265788,369,274,280,51,10,57,31.5,36.13890978,14,274,238,456,288,694,5669.927951,11.64963504,66052.5913,3669.588406,1.889975984
5.385265788,205,144,147,20,4,38,38,45.66173035,14,127,117,226,141,343,2448.866114,12.45669291,30504.77317,1694.70962,0.816288705
5.238378523,350,241,247,38,10,71,24,38.31751212,14,303,246,466,317,712,5915.537389,10.76567657,63684.76226,3538.042348,1.971845796
5.207686579,212,144,147,32,3,40,45,47.27297624,14,148,134,260,162,394,2891.900901,12.2972973,35562.56514,1975.698063,0.96396697
5.180104182,224,156,159,37,4,40,43,47.25882487,14,156,140,269,170,409,3030.440893,12.07051282,36578.97565,2032.165314,1.010146964
5.12194103,408,293,301,27,14,86,34.5,30.7307943,14,279,250,474,293,724,5933.003963,11.89247312,70558.09014,3919.893896,1.977667988
4.909598524,197,134,138,58,5,37,31,54.44332703,14,129,116,219,143,335,2398.556898,11.88372093,28503.78081,1583.543378,0.799518966
5.962942749,256,166,167,39,5,55,40,46.4493345,15,195,175,334,210,509,3926.550968,12.84615385,50441.07783,2802.282101,1.308850323
5.962942749,272,184,192,68,5,52,44,46.89781604,15,225,199,381,240,580,4585.996545,12.7,58242.15613,3235.67534,1.528665515
5.962942749,250,181,189,11,7,44,43,36.55111573,15,232,204,391,247,595,4729.278503,12.64008621,59778.48797,3321.02711,1.576426168
5.894375918,234,152,155,48,6,46,40,49.35320602,15,189,168,321,204,489,3751.815992,12.73809524,47790.98942,2655.054968,1.250605331
5.894375918,215,148,158,22,5,38,36,44.7252025,15,195,169,321,210,490,3779.9803,12.34615385,46668.21836,2592.678798,1.259993435
5.894375918,475,328,348,44,9,85,38.5,27.67351343,15,461,418,795,476,1213,10789.41395,12.93383948,139548.5481,7752.697115,3.596471316
5.894375918,217,149,159,24,6,38,36,45.47052255,15,196,169,321,211,490,3783.338602,12.28316327,46471.36574,2581.742541,1.261112867
5.894375918,216,148,158,28,5,38,36,46.3641289,15,195,169,321,210,490,3779.9803,12.34615385,46668.21836,2592.678798,1.259993435
5.894375918,250,163,166,52,6,49,41,48.29704981,15,201,182,348,216,530,4110.090376,12.98507463,53369.8303,2964.99057,1.370030125
5.894375918,234,152,155,48,6,46,40,49.35320602,15,189,168,321,204,489,3751.815992,12.73809524,47790.98942,2655.054968,1.250605331
5.73131892,243,168,177,30,7,40,38,45.27220123,15,175,152,290,190,442,3345.876179,12.42857143,41584.46108,2310.247838,1.11529206
5.678458275,212,148,162,34,6,35,36,48.68271807,15,161,125,241,176,366,2730.151972,11.22670807,30650.61919,1702.812177,0.910050657
5.656042032,453,313,333,72,8,72,39,32.96142182,15,327,287,554,342,841,7079.41397,12.70642202,89954.02148,4997.445638,2.359804655
5.645460536,410,280,286,35,12,86,36,32.26196973,15,282,249,479,297,728,5980.02432,12.7393617,76181.6928,4232.316267,1.99334144
5.570815399,229,151,154,34,6,46,38,47.64102367,15,193,168,320,208,488,3757.814582,12.43523316,46729.30051,2596.07225,1.252604861
5.570815399,233,153,156,36,7,46,38,47.90078284,15,195,171,326,210,497,3833.980022,12.53846154,48072.21105,2670.678392,1.277993341
5.57029068,217,147,150,35,3,41,47,47.0892829,15,155,142,275,170,417,3089.71602,13.30645161,41113.15672,2284.064262,1.02990534
5.57029068,236,152,155,49,6,47,40,49.46099031,15,190,168,321,205,489,3755.265769,12.67105263,47583.1702,2643.509456,1.251755256
5.57029068,219,148,151,38,4,41,47,47.75342904,15,154,141,273,169,414,3063.964087,13.29545455,40736.79524,2263.155291,1.021321362
5.57029068,237,153,156,51,6,47,40,49.56728735,15,191,168,321,206,489,3758.698758,12.60471204,47377.31549,2632.073083,1.252899586
5.57029068,256,172,175,47,6,49,40,47.32486336,15,197,164,312,212,476,3678.490136,11.87817259,43693.74071,2427.430039,1.226163379
5.57029068,239,154,157,49,7,47,40,49.2832742,15,194,172,329,209,501,3861.386925,12.71907216,49113.25896,2728.514387,1.287128975
5.57029068,217,147,150,35,3,41,47,47.0892829,15,155,142,275,170,417,3089.71602,13.30645161,41113.15672,2284.064262,1.02990534
5.568681318,220,152,155,36,4,42,47,46.90293155,15,154,143,276,169,419,3100.968484,13.44155844,41681.8491,2315.658283,1.033656161
5.556645379,208,137,147,32,4,36,35,49.76857254,15,133,118,227,148,345,2487.261411,12.80075188,31838.8162,1768.823121,0.829087137
6.02536959,482,362,368,21,10,100,50,19.2942476,15,429,386,742,444,1128,9920.1011,12.97202797,128683.8289,7149.101607,3.30670037
5.96402885,254,182,190,15,6,47,43,37.56698829,15,236,208,399,251,607,4838.726937,12.68008475,61355.46763,3408.63709,1.612908979
5.962970643,480,332,341,20,18,112,40,25.22709773,15,395,354,676,410,1030,8939.8645,12.83544304,114747.1216,6374.840088,2.979954834
5.962942749,256,166,167,39,5,55,40,46.4493345,15,195,175,334,210,509,3926.550968,12.84615385,50441.07783,2802.282101,1.308850323
5.962942749,272,184,192,68,5,52,44,46.89781604,15,225,199,381,240,580,4585.996545,12.7,58242.15613,3235.67534,1.528665515
5.962942749,250,181,189,11,7,44,43,36.55111573,15,232,204,391,247,595,4729.278503,12.64008621,59778.48797,3321.02711,1.576426168
5.962942749,257,166,167,39,6,55,40,46.61817921,15,195,175,334,210,509,3926.550968,12.84615385,50441.07783,2802.282101,1.308850323
5.962942749,276,186,194,69,6,52,45,46.71832452,15,225,201,385,240,586,4633.437889,12.83333333,59462.45291,3303.469606,1.544479296
5.962942749,272,184,192,69,5,52,44,46.98852357,15,224,198,379,239,577,4558.800148,12.68973214,57849.95277,3213.886265,1.519600049
5.928162258,254,175,184,43,5,43,39,46.15378722,15,191,167,320,206,487,3743.325757,12.56544503,47036.554,2613.14189,1.247775252
5.896653717,257,173,176,29,6,58,44,43.31040857,15,194,174,333,209,507,3907.63108,12.87371134,50305.71455,2794.76192,1.302543693
5.894963474,237,158,161,39,5,47,41,47.06931091,15,197,174,332,212,506,3910.32775,12.63959391,49424.95481,2745.830823,1.303442583
5.894375918,234,152,155,48,6,46,40,49.35320602,15,189,168,321,204,489,3751.815992,12.73809524,47790.98942,2655.054968,1.250605331
5.894375918,215,148,158,22,5,38,36,44.7252025,15,195,169,321,210,490,3779.9803,12.34615385,46668.21836,2592.678798,1.259993435
5.894375918,475,328,348,44,9,85,38.5,27.67351343,15,461,418,795,476,1213,10789.41395,12.93383948,139548.5481,7752.697115,3.596471316
5.894375918,217,149,159,24,6,38,36,45.47052255,15,196,169,321,211,490,3783.338602,12.28316327,46471.36574,2581.742541,1.261112867
5.894375918,216,148,158,28,5,38,36,46.3641289,15,195,169,321,210,490,3779.9803,12.34615385,46668.21836,2592.678798,1.259993435
5.894375918,250,163,166,52,6,49,41,48.29704981,15,201,182,348,216,530,4110.090376,12.98507463,53369.8303,2964.99057,1.370030125
5.894375918,234,152,155,48,6,46,40,49.35320602,15,189,168,321,204,489,3751.815992,12.73809524,47790.98942,2655.054968,1.250605331
5.894375918,222,150,160,29,7,40,36,46.75054528,15,199,173,329,214,502,3886.216427,12.39949749,48187.13082,2677.062824,1.295405476
5.894375918,224,155,165,28,7,38,38,45.76116958,15,196,170,323,211,493,3806.5019,12.35969388,47047.19823,2613.733235,1.268833967
5.894375918,266,184,194,38,4,46,41,42.50037702,15,272,254,484,287,738,6025.701312,13.34558824,80416.52854,4467.584919,2.008567104
5.894375918,216,149,159,29,4,38,36,46.27067489,15,194,168,319,209,487,3753.4839,12.33247423,46289.7434,2571.652412,1.251161299
5.894375918,219,150,160,17,6,39,36,43.10043468,15,199,173,329,214,502,3886.216427,12.39949749,48187.13082,2677.062824,1.295405476
5.894375918,222,161,171,10,4,43,38,37.71108239,15,206,178,339,221,517,4026.34562,12.34223301,49694.09586,2760.783103,1.342115208
6.281454359,310,211,220,50,6,55,48,42.06460342,15,248,215,415,263,630,5064.518963,12.55040323,63561.75513,3531.20862,1.688172988
6.213612806,529,364,382,73,8,89,39,29.79186712,15,408,355,682,423,1037,9047.320866,12.53676471,113424.1329,6301.340717,3.015773622
6.02536959,482,362,368,21,10,100,50,19.2942476,15,429,386,742,444,1128,9920.1011,12.97202797,128683.8289,7149.101607,3.30670037
6.02536959,482,362,368,21,10,100,50,19.2942476,15,429,386,742,444,1128,9920.1011,12.97202797,128683.8289,7149.101607,3.30670037
6.01043374,488,365,371,24,11,101,50,20.02286907,15,432,389,748,447,1137,10010.29697,12.98611111,129994.8287,7221.934929,3.336765657
5.9640981,263,187,195,21,9,48,45,39.55877446,15,241,216,415,256,631,5048,12.9149378,65194.60581,3621.922545,1.682666667
5.96402885,254,182,190,15,6,47,43,37.56698829,15,236,208,399,251,607,4838.726937,12.68008475,61355.46763,3408.63709,1.612908979
5.96402885,269,186,194,57,5,49,44,45.4581076,15,246,215,412,261,627,5033.49706,12.56097561,63225.6338,3512.535211,1.677832353
5.96402885,272,195,203,44,5,52,45,42.78682928,15,247,217,417,262,634,5093.190183,12.66194332,64489.68541,3582.760301,1.697730061
5.963096736,257,167,168,40,6,54,40,46.6164134,15,199,178,340,214,518,4010.079899,12.81407035,51385.44594,2854.746997,1.3366933
5.962970643,480,332,341,20,18,112,40,25.22709773,15,395,354,676,410,1030,8939.8645,12.83544304,114747.1216,6374.840088,2.979954834
5.962942749,256,166,167,39,5,55,40,46.4493345,15,195,175,334,210,509,3926.550968,12.84615385,50441.07783,2802.282101,1.308850323
5.962942749,272,184,192,68,5,52,44,46.89781604,15,225,199,381,240,580,4585.996545,12.7,58242.15613,3235.67534,1.528665515
5.962942749,250,181,189,11,7,44,43,36.55111573,15,232,204,391,247,595,4729.278503,12.64008621,59778.48797,3321.02711,1.576426168
5.962942749,257,166,167,39,6,55,40,46.61817921,15,195,175,334,210,509,3926.550968,12.84615385,50441.07783,2802.282101,1.308850323
5.962942749,276,186,194,69,6,52,45,46.71832452,15,225,201,385,240,586,4633.437889,12.83333333,59462.45291,3303.469606,1.544479296
5.962942749,272,184,192,69,5,52,44,46.98852357,15,224,198,379,239,577,4558.800148,12.68973214,57849.95277,3213.886265,1.519600049
5.962942749,245,184,192,0,5,48,44,28.50132474,15,225,199,381,240,580,4585.996545,12.7,58242.15613,3235.67534,1.528665515
5.962942749,235,159,169,29,6,42,37,45.21258259,15,209,182,347,224,529,4130.090754,12.45215311,51428.52242,2857.14013,1.376696918
5.962942749,257,166,167,39,6,55,40,46.59760832,15,196,176,336,211,512,3953.202785,12.85714286,50826.89295,2823.716275,1.317734262
5.962942749,274,183,191,69,6,52,43,47.28499934,15,225,197,377,240,574,4538.5552,12.56666667,57034.51037,3168.583909,1.512851734
5.962942749,255,181,189,12,11,45,43,38.40953029,15,234,206,395,249,601,4783.961161,12.66025641,60566.17496,3364.787498,1.59465372
5.962942749,254,181,189,13,10,45,43,38.44448963,15,232,204,391,247,595,4729.278503,12.64008621,59778.48797,3321.02711,1.576426168
5.962942749,555,410,423,24,10,108,48,17.94344475,15,483,428,823,498,1251,11208.96242,12.77950311,143244.97,7958.05389,3.73632081
5.962942749,260,169,170,40,6,55,41,46.21460263,15,200,182,347,215,529,4098.794017,13.0125,53335.55715,2963.086508,1.366264672
6.281454359,310,211,220,50,6,55,48,42.06460342,15,248,215,415,263,630,5064.518963,12.55040323,63561.75513,3531.20862,1.688172988
6.213612806,529,364,382,73,8,89,39,29.79186712,15,408,355,682,423,1037,9047.320866,12.53676471,113424.1329,6301.340717,3.015773622
6.077209836,281,216,219,4,6,55,58,27.7007989,15,241,218,421,256,639,5112,13.10165975,66975.6846,3720.871369,1.704
6.02536959,482,362,368,21,10,100,50,19.2942476,15,429,386,742,444,1128,9920.1011,12.97202797,128683.8289,7149.101607,3.30670037
6.02536959,482,362,368,21,10,100,50,19.2942476,15,429,386,742,444,1128,9920.1011,12.97202797,128683.8289,7149.101607,3.30670037
6.02536959,510,385,391,28,11,103,55,18.45683909,15,448,404,778,463,1182,10466.4544,13.02455357,136320.8964,7573.383134,3.488818143
6.02536959,271,206,209,21,4,54,59,34.79169018,15,236,212,409,251,621,4950.32855,12.99788136,64343.78313,3574.654618,1.650109516
6.02536959,272,206,209,11,4,55,59,30.99575416,15,236,212,409,251,621,4950.32855,12.99788136,64343.78313,3574.654618,1.650109516
6.02536959,94,61,65,15,5,20,9,69.1284062,7,27,20,40,34,60,305.2477705,5.185185185,1582.766217,87.93145652,0.101749257
6.02181162,258,185,193,18,5,48,44,37.84184354,15,241,209,401,256,610,4880,12.47925311,60898.75519,3383.264177,1.626666667
6.01043374,488,365,371,24,11,101,50,20.02286907,15,432,389,748,447,1137,10010.29697,12.98611111,129994.8287,7221.934929,3.336765657
6.01043374,487,364,370,26,11,101,50,20.47107625,15,433,391,752,448,1143,10066.80668,13.02540416,131124.2255,7284.679196,3.355602225
6.01043374,488,365,371,24,11,101,50,20.02286907,15,432,389,748,447,1137,10010.29697,12.98611111,129994.8287,7221.934929,3.336765657
6.006344065,501,380,386,26,10,101,52,19.04168327,15,437,386,740,452,1126,9931.52151,12.70022883,126132.5959,7007.366437,3.310507171
5.979011795,317,234,242,33,6,55,64,34.78030447,15,278,246,475,293,721,5908.419692,12.8147482,75714.9106,4206.383923,1.969473231
5.9640981,263,187,195,21,9,48,45,39.55877446,15,241,216,415,256,631,5048,12.9149378,65194.60581,3621.922545,1.682666667
5.9640981,273,194,202,30,4,50,46,39.75542087,15,243,220,422,258,642,5143.207898,13.02469136,66988.69546,3721.594192,1.714402633
5.96402885,254,182,190,15,6,47,43,37.56698829,15,236,208,399,251,607,4838.726937,12.68008475,61355.46763,3408.63709,1.612908979
5.96402885,269,186,194,57,5,49,44,45.4581076,15,246,215,412,261,627,5033.49706,12.56097561,63225.6338,3512.535211,1.677832353
5.96402885,272,195,203,44,5,52,45,42.78682928,15,247,217,417,262,634,5093.190183,12.66194332,64489.68541,3582.760301,1.697730061
5.96402885,273,188,196,58,6,50,45,45.31859369,15,247,218,418,262,636,5109.257029,12.69230769,64848.26229,3602.681238,1.703085676
5.96402885,274,204,212,13,5,48,48,33.58247002,15,249,223,429,264,652,5244.944966,12.92168675,67773.5359,3765.196436,1.748314989
5.96402885,272,195,203,45,5,52,45,42.94417197,15,247,217,417,262,634,5093.190183,12.66194332,64489.68541,3582.760301,1.697730061
5.96402885,268,189,197,15,9,51,45,37.66568248,15,238,210,404,253,614,4901.558055,12.73109244,62402.18868,3466.78826,1.633852685
5.96402885,258,183,191,17,6,48,43,38.15318979,15,238,210,403,253,613,4893.575061,12.69957983,62146.34715,3452.574842,1.631191687
7.753795095,342,249,257,90,5,60,67,39.73150674,15,295,267,516,310,783,6480.205409,13.11864407,85011.50825,4722.86157,2.16006847
6.83909109,327,241,243,57,4,63,64,37.84315376,15,284,265,511,299,776,6381.825299,13.49471831,86120.9347,4784.496373,2.1272751
6.281454359,310,211,220,50,6,55,48,42.06460342,15,248,215,415,263,630,5064.518963,12.55040323,63561.75513,3531.20862,1.688172988
6.231053825,318,234,242,16,7,55,64,30.60104319,15,278,246,475,293,721,5908.419692,12.8147482,75714.9106,4206.383923,1.969473231
6.213612806,529,364,382,73,8,89,39,29.79186712,15,408,355,682,423,1037,9047.320866,12.53676471,113424.1329,6301.340717,3.015773622
6.203268739,494,371,377,25,12,101,51,19.85351871,15,435,394,758,450,1152,10153.47593,13.06896552,132695.4268,7371.968158,3.384491977
6.085250561,345,246,255,48,5,66,51,37.6565185,15,314,283,544,329,827,6915.327501,12.99363057,89855.21084,4991.956158,2.305109167
6.079632331,549,378,394,64,10,101,43.5,26.42579908,15,511,448,859,526,1307,11813.86712,12.60763209,148944.8902,8274.716125,3.937955706
6.077209836,281,216,219,4,6,55,58,27.7007989,15,241,218,421,256,639,5112,13.10165975,66975.6846,3720.871369,1.704
6.077209836,305,236,239,7,7,57,65,27.19405401,15,258,234,453,273,687,5559.724156,13.16860465,73213.80938,4067.433854,1.853241385
6.077209836,282,216,219,5,6,55,58,28.26880308,15,241,218,421,256,639,5112,13.10165975,66975.6846,3720.871369,1.704
6.077209836,281,216,219,4,6,55,58,27.7007989,15,241,218,421,256,639,5112,13.10165975,66975.6846,3720.871369,1.704
6.02536959,482,362,368,21,10,100,50,19.2942476,15,429,386,742,444,1128,9920.1011,12.97202797,128683.8289,7149.101607,3.30670037
6.02536959,482,362,368,21,10,100,50,19.2942476,15,429,386,742,444,1128,9920.1011,12.97202797,128683.8289,7149.101607,3.30670037
6.02536959,510,385,391,28,11,103,55,18.45683909,15,448,404,778,463,1182,10466.4544,13.02455357,136320.8964,7573.383134,3.488818143
6.02536959,271,206,209,21,4,54,59,34.79169018,15,236,212,409,251,621,4950.32855,12.99788136,64343.78313,3574.654618,1.650109516
6.02536959,272,206,209,11,4,55,59,30.99575416,15,236,212,409,251,621,4950.32855,12.99788136,64343.78313,3574.654618,1.650109516
6.02536959,94,61,65,15,5,20,9,69.1284062,7,27,20,40,34,60,305.2477705,5.185185185,1582.766217,87.93145652,0.101749257
6.02536959,267,206,209,0,4,54,59,23.85280487,15,236,212,409,251,621,4950.32855,12.99788136,64343.78313,3574.654618,1.650109516
6.02536959,288,216,219,31,4,59,61,36.2934156,15,244,219,423,259,642,5146.790921,13.00204918,66918.82867,3717.712704,1.715596974
6.02536959,272,206,209,11,4,55,59,30.99575416,15,236,212,409,251,621,4950.32855,12.99788136,64343.78313,3574.654618,1.650109516
6.02300867,334,245,253,37,4,59,65,34.09863875,15,290,257,497,305,754,6222.509736,12.85344828,79980.70704,4443.372613,2.074169912
6.02181162,258,185,193,18,5,48,44,37.84184354,15,241,209,401,256,610,4880,12.47925311,60898.75519,3383.264177,1.626666667
6.02181162,264,187,195,22,6,50,47,38.79667288,15,243,211,405,258,616,4934.915989,12.5,61686.44987,3427.024993,1.644971996
6.02181162,258,185,193,20,4,48,44,38.17914495,15,241,209,401,256,610,4880,12.47925311,60898.75519,3383.264177,1.626666667
9.30909981,490,369,370,25,10,104,50,19.79286475,15,436,390,750,451,1140,10051.36133,12.90137615,129676.3933,7204.244073,3.350453777
7.753795095,342,249,257,90,5,60,67,39.73150674,15,295,267,516,310,783,6480.205409,13.11864407,85011.50825,4722.86157,2.16006847
7.753795095,344,251,259,91,4,60,68,39.41447176,15,298,272,526,313,798,6615.43504,13.23825503,87576.81622,4865.378679,2.205145013
7.753795095,343,249,257,90,6,60,67,39.79006952,15,295,267,516,310,783,6480.205409,13.11864407,85011.50825,4722.86157,2.16006847
6.83909109,327,241,243,57,4,63,64,37.84315376,15,284,265,511,299,776,6381.825299,13.49471831,86120.9347,4784.496373,2.1272751
6.528344852,424,307,316,81,6,81,71,34.52370827,15,361,329,636,376,965,8255.17824,13.2132964,109078.1169,6059.895385,2.751726081
6.324405756,347,247,256,30,5,65,51,34.2009248,15,313,283,544,328,827,6911.695508,13.03514377,90094.94464,5005.274702,2.303898503
6.281454359,310,211,220,50,6,55,48,42.06460342,15,248,215,415,263,630,5064.518963,12.55040323,63561.75513,3531.20862,1.688172988
6.231053825,318,234,242,16,7,55,64,30.60104319,15,278,246,475,293,721,5908.419692,12.8147482,75714.9106,4206.383923,1.969473231
6.213612806,529,364,382,73,8,89,39,29.79186712,15,408,355,682,423,1037,9047.320866,12.53676471,113424.1329,6301.340717,3.015773622
6.203268739,494,371,377,25,12,101,51,19.85351871,15,435,394,758,450,1152,10153.47593,13.06896552,132695.4268,7371.968158,3.384491977
6.200481873,356,254,262,95,10,63,68,39.71747587,15,304,276,534,319,810,6737.104217,13.17434211,88756.91576,4930.939764,2.245701406
6.155784568,438,318,327,74,5,78,75,32.53377264,15,372,341,659,387,1000,8596.18976,13.28629032,114211.4728,6345.08182,2.865396585
6.085250561,345,246,255,48,5,66,51,37.6565185,15,314,283,544,329,827,6915.327501,12.99363057,89855.21084,4991.956158,2.305109167
6.079632331,549,378,394,64,10,101,43.5,26.42579908,15,511,448,859,526,1307,11813.86712,12.60763209,148944.8902,8274.716125,3.937955706
6.077524218,286,217,220,7,7,56,59,29.51303866,15,245,223,431,260,654,5246.62855,13.19387755,69223.37464,3845.743036,1.748876183
6.077209836,281,216,219,4,6,55,58,27.7007989,15,241,218,421,256,639,5112,13.10165975,66975.6846,3720.871369,1.704
6.077209836,305,236,239,7,7,57,65,27.19405401,15,258,234,453,273,687,5559.724156,13.16860465,73213.80938,4067.433854,1.853241385
6.077209836,282,216,219,5,6,55,58,28.26880308,15,241,218,421,256,639,5112,13.10165975,66975.6846,3720.871369,1.704
6.077209836,281,216,219,4,6,55,58,27.7007989,15,241,218,421,256,639,5112,13.10165975,66975.6846,3720.871369,1.704
6.077209836,307,236,239,9,8,58,65,28.4859511,15,258,234,453,273,687,5559.724156,13.16860465,73213.80938,4067.433854,1.853241385
6.077209836,327,240,248,35,7,55,65,34.85107634,15,271,244,471,286,715,5834.308006,13.03505535,76050.52779,4225.029322,1.944769335
6.077209836,305,236,239,7,7,57,65,27.19405401,15,258,234,453,273,687,5559.724156,13.16860465,73213.80938,4067.433854,1.853241385
6.077209836,310,239,242,10,8,58,65,28.64541909,15,260,236,457,275,693,5615.578451,13.18269231,74028.44285,4112.69127,1.871859484
6.077209836,574,442,447,19,10,113,59,12.64432534,15,498,446,861,513,1307,11766.67923,12.96686747,152576.9701,8476.49834,3.922226408
9.30909981,490,369,370,25,10,104,50,19.79286475,15,436,390,750,451,1140,10051.36133,12.90137615,129676.3933,7204.244073,3.350453777
7.753795095,342,249,257,90,5,60,67,39.73150674,15,295,267,516,310,783,6480.205409,13.11864407,85011.50825,4722.86157,2.16006847
7.753795095,344,251,259,91,4,60,68,39.41447176,15,298,272,526,313,798,6615.43504,13.23825503,87576.81622,4865.378679,2.205145013
7.753795095,343,249,257,90,6,60,67,39.79006952,15,295,267,516,310,783,6480.205409,13.11864407,85011.50825,4722.86157,2.16006847
7.753795095,368,271,279,95,5,62,79,36.78698592,15,320,295,572,335,867,7272.410986,13.40625,97495.75979,5416.431099,2.424136995
7.753795095,351,271,279,3,9,62,78,21.44248702,15,321,295,572,336,867,7276.139206,13.36448598,97241.8604,5402.325578,2.425379735
6.83909109,327,241,243,57,4,63,64,37.84315376,15,284,265,511,299,776,6381.825299,13.49471831,86120.9347,4784.496373,2.1272751
6.528344852,424,307,316,81,6,81,71,34.52370827,15,361,329,636,376,965,8255.17824,13.2132964,109078.1169,6059.895385,2.751726081
6.479480264,353,275,283,1,7,62,77,19.26069866,15,320,293,568,335,861,7222.082883,13.3125,96143.97838,5341.332132,2.407360961
6.419058739,333,255,263,6,9,61,69,25.12119027,15,305,280,542,320,822,6840.624894,13.32786885,91170.95146,5065.052859,2.280208298
6.419058739,247,184,186,14,5,54,50,36.29621922,15,212,195,375,227,570,4461.132638,13.26650943,59183.65822,3287.981012,1.487044213
6.355756585,347,247,256,30,5,65,51,34.2009248,15,313,283,544,328,827,6911.695508,13.03514377,90094.94464,5005.274702,2.303898503
6.324405756,347,247,256,30,5,65,51,34.2009248,15,313,283,544,328,827,6911.695508,13.03514377,90094.94464,5005.274702,2.303898503
6.281454359,310,211,220,50,6,55,48,42.06460342,15,248,215,415,263,630,5064.518963,12.55040323,63561.75513,3531.20862,1.688172988
6.231053825,318,234,242,16,7,55,64,30.60104319,15,278,246,475,293,721,5908.419692,12.8147482,75714.9106,4206.383923,1.969473231
6.231053825,327,242,250,21,7,56,66,31.15943289,15,284,254,491,299,745,6126.881247,12.9665493,79444.50772,4413.583762,2.042293749
6.231053825,321,233,241,19,8,57,62,32.18371973,15,277,245,473,292,718,5880.294033,12.80685921,75308.09777,4183.78321,1.960098011
6.213612806,529,364,382,73,8,89,39,29.79186712,15,408,355,682,423,1037,9047.320866,12.53676471,113424.1329,6301.340717,3.015773622
6.203268739,494,371,377,25,12,101,51,19.85351871,15,435,394,758,450,1152,10153.47593,13.06896552,132695.4268,7371.968158,3.384491977
6.200481873,356,254,262,95,10,63,68,39.71747587,15,304,276,534,319,810,6737.104217,13.17434211,88756.91576,4930.939764,2.245701406
6.200481873,366,262,270,102,11,64,70,39.2673979,15,312,283,548,327,831,6941.465012,13.17307692,91440.45256,5080.025142,2.313821671
6.155784568,438,318,327,74,5,78,75,32.53377264,15,372,341,659,387,1000,8596.18976,13.28629032,114211.4728,6345.08182,2.865396585
6.116580635,445,321,330,77,6,79,76,32.56616156,15,376,347,670,391,1017,8757.412219,13.3643617,117037.2245,6502.068026,2.919137406
6.11342155,291,219,222,8,7,58,59,29.7793518,15,248,226,437,263,663,5329.80329,13.21572581,70437.21888,3913.178827,1.776601097
6.106567226,359,256,264,97,11,63,68,39.69247158,15,307,280,542,322,822,6848.013674,13.24104235,90674.839,5037.491058,2.282671225