fitness_score,loc,lloc,sloc,comment,multi,blank,avg_cyclomatic_complexity,maintainability_index,halstead_h1,halstead_h2,halstead_N1,halstead_N2,halstead_vocabulary,halstead_length,halstead_volume,halstead_difficulty,halstead_effort,halstead_time,halstead_bugs
0.761062292091458,65,34,47,11,0,9,0.0,78.17605575625649,3,9,5,10,12,15,53.77443751081735,1.6666666666666667,89.62406251802892,4.9791145843349405,0.017924812503605784
0.9725369126244651,47,26,35,5,0,7,0.0,79.06844052721269,2,6,3,6,8,9,27.0,1.0,27.0,1.5,0.009
0.9725369126244651,31,20,19,1,6,5,5.0,88.74273097958164,2,6,3,6,8,9,27.0,1.0,27.0,1.5,0.009
1.6471703113953136,52,24,33,12,0,8,0.0,84.09261462575435,5,11,6,12,16,18,72.0,2.727272727272727,196.36363636363635,10.909090909090908,0.024
0.853901143761556,35,23,21,8,0,7,0.0,87.60342010804261,2,6,3,6,8,9,27.0,1.0,27.0,1.5,0.009
1.6675916849793366,55,37,36,4,6,10,7.0,77.86919204667477,5,10,6,12,15,18,70.32403072095333,3.0,210.97209216286,11.720671786825555,0.02344134357365111
1.3467572330483153,45,31,29,11,0,9,0.0,82.29176742569013,4,9,5,10,13,15,55.506595772116384,2.2222222222222223,123.34799060470309,6.852666144705727,0.01850219859070546
0.9725369126244651,50,31,33,8,0,10,0.0,80.3720702876404,3,7,4,8,10,12,39.863137138648355,1.7142857142857142,68.33680652339717,3.796489251299843,0.013287712379549451
0.853901143761556,55,34,32,15,6,8,11.0,79.70949199202522,6,14,9,18,20,27,116.69205856195879,3.857142857142857,450.09794016755535,25.005441120419743,0.03889735285398626
0.9725369126244651,67,30,43,12,0,12,0.0,79.89010238603761,4,11,6,12,15,18,70.32403072095333,2.1818181818181817,153.43424884571635,8.52412493587313,0.02344134357365111
0.7610622920914578,44,32,32,10,0,6,0.0,78.27027395196056,5,15,9,18,20,27,116.69205856195879,3.0,350.07617568587636,19.44867642699313,0.03889735285398626
0.9725369126244651,33,23,21,6,0,6,0.0,85.75875818836347,3,5,3,6,8,9,27.0,1.8,48.6,2.7,0.009
0.8141740493631464,46,28,34,6,0,7,0.0,76.3107440543065,6,9,7,14,15,21,82.0447025077789,4.666666666666667,382.8752783696349,21.27084879831305,0.02734823416925963
4.89169075846944,38,23,23,10,0,7,0.0,85.95270294103729,4,10,5,10,14,15,57.110323830864054,2.0,114.22064766172811,6.345591536762672,0.019036774610288017
0.6194681409099084,40,25,24,10,0,8,0.0,81.31041084594003,8,17,12,24,25,36,167.17882283189007,5.647058823529412,944.0686465800852,52.448258143338066,0.05572627427729669
0.8048132202416446,45,32,32,10,0,7,0.0,80.89521512967345,3,9,5,10,12,15,53.77443751081735,1.6666666666666667,89.62406251802892,4.9791145843349405,0.017924812503605784
1.129456670191816,44,28,25,8,7,9,9.0,82.49819434076885,7,10,8,16,17,24,98.09910819000817,5.6,549.3550058640457,30.519722548002537,0.03269970273000272
0.9725369126244651,46,28,26,3,6,11,6.0,83.86753981567577,3,7,4,8,10,12,39.863137138648355,1.7142857142857142,68.33680652339717,3.796489251299843,0.013287712379549451
1.2197277703406781,48,36,34,6,0,8,0.0,72.89373911238077,4,13,9,18,17,27,110.36149671375918,2.769230769230769,305.6164524381023,16.978691802116796,0.03678716557125306
0.9725369126244651,41,25,29,7,0,5,0.0,81.05921699880754,4,7,6,11,11,17,58.81033751683406,3.142857142857143,184.83248933862134,10.268471629923408,0.019603445838944685
1.1779891542264571,44,32,29,10,0,8,3.0,82.72131333395691,3,6,4,8,9,12,38.03910001730775,2.0,76.0782000346155,4.226566668589751,0.012679700005769252
0.9093660517385167,53,33,31,9,6,11,12.0,78.61771265675904,6,21,12,24,27,36,171.1759500778849,3.4285714285714284,586.8889716956053,32.60494287197807,0.05705865002596163
1.6675916849793366,63,37,45,5,0,14,3.0,71.44606962078747,4,10,5,10,14,15,57.110323830864054,2.0,114.22064766172811,6.345591536762672,0.019036774610288017
0.7610622920914578,35,26,24,6,0,7,0.0,82.15392042689966,3,8,4,8,11,12,41.51317942364757,1.5,62.26976913547136,3.4594316186372978,0.01383772647454919
0.6864312956318976,31,20,18,9,0,6,0.0,88.58475229213529,4,8,4,8,12,12,43.01955000865388,2.0,86.03910001730776,4.779950000961542,0.014339850002884626
4.89169075846944,38,23,23,10,0,7,0.0,85.95270294103729,4,10,5,10,14,15,57.110323830864054,2.0,114.22064766172811,6.345591536762672,0.019036774610288017
2.599978695743248,63,37,46,9,0,13,10.0,72.46902515564568,5,17,11,22,22,33,147.1612434150308,3.235294117647059,476.1099051662762,26.450550287015343,0.04905374780501027
2.5948315988836113,76,49,48,14,6,15,11.0,72.78473615948097,7,30,19,38,37,57,296.93884184085016,4.433333333333334,1316.4288654944357,73.13493697191309,0.09897961394695005
2.2300198512981466,49,34,34,14,0,8,0.0,81.0393562155881,5,11,6,12,16,18,72.0,2.727272727272727,196.36363636363635,10.909090909090908,0.024
1.6675916849793366,55,37,36,4,6,10,7.0,77.86919204667477,5,10,6,12,15,18,70.32403072095333,3.0,210.97209216286,11.720671786825555,0.02344134357365111
1.6675916849793366,63,37,45,5,0,14,3.0,71.44606962078747,4,10,5,10,14,15,57.110323830864054,2.0,114.22064766172811,6.345591536762672,0.019036774610288017
1.6471703113953136,52,24,33,12,0,8,0.0,84.09261462575435,5,11,6,12,16,18,72.0,2.727272727272727,196.36363636363635,10.909090909090908,0.024
1.5905423660240647,41,27,27,10,0,7,0.0,83.51679275536885,4,10,5,10,14,15,57.110323830864054,2.0,114.22064766172811,6.345591536762672,0.019036774610288017
1.4163360904027316,48,36,33,11,0,8,5.0,77.66565027181387,7,14,9,18,21,27,118.59257041502654,4.5,533.6665668676194,29.648142603756632,0.03953085680500885
1.3891685114505885,62,47,47,13,0,8,0.0,72.30440346702704,6,18,12,24,24,36,165.05865002596164,4.0,660.2346001038466,36.679700005769256,0.05501955000865388
1.3467572330483153,45,31,29,11,0,9,0.0,82.29176742569013,4,9,5,10,13,15,55.506595772116384,2.2222222222222223,123.34799060470309,6.852666144705727,0.01850219859070546
1.3467572330483153,61,37,34,9,6,15,8.0,78.10157398592952,6,19,11,22,25,33,153.24725426256592,3.473684210526316,532.332567438387,29.57403152435483,0.05108241808752197
1.2197277703406781,48,36,34,6,0,8,0.0,72.89373911238077,4,13,9,18,17,27,110.36149671375918,2.769230769230769,305.6164524381023,16.978691802116796,0.03678716557125306
1.198838392069847,67,40,39,12,6,14,12.0,75.41291275293824,7,26,17,34,33,51,257.2641000872811,4.576923076923077,1177.477996553325,65.4154442529625,0.0857547000290937
1.1779891542264571,44,32,29,10,0,8,3.0,82.72131333395691,3,6,4,8,9,12,38.03910001730775,2.0,76.0782000346155,4.226566668589751,0.012679700005769252
1.1779891542264571,52,37,34,14,0,10,3.0,81.16393193452527,4,9,5,10,13,15,55.506595772116384,2.2222222222222223,123.34799060470309,6.852666144705727,0.01850219859070546
1.129456670191816,44,28,25,8,7,9,9.0,82.49819434076885,7,10,8,16,17,24,98.09910819000817,5.6,549.3550058640457,30.519722548002537,0.03269970273000272
0.9725369126244651,47,26,35,5,0,7,0.0,79.06844052721269,2,6,3,6,8,9,27.0,1.0,27.0,1.5,0.009
0.9725369126244651,31,20,19,1,6,5,5.0,88.74273097958164,2,6,3,6,8,9,27.0,1.0,27.0,1.5,0.009
0.9725369126244651,50,31,33,8,0,10,0.0,80.3720702876404,3,7,4,8,10,12,39.863137138648355,1.7142857142857142,68.33680652339717,3.796489251299843,0.013287712379549451
0.9725369126244651,67,30,43,12,0,12,0.0,79.89010238603761,4,11,6,12,15,18,70.32403072095333,2.1818181818181817,153.43424884571635,8.52412493587313,0.02344134357365111
0.9725369126244651,33,23,21,6,0,6,0.0,85.75875818836347,3,5,3,6,8,9,27.0,1.8,48.6,2.7,0.009
0.9725369126244651,46,28,26,3,6,11,6.0,83.86753981567577,3,7,4,8,10,12,39.863137138648355,1.7142857142857142,68.33680652339717,3.796489251299843,0.013287712379549451
0.9725369126244651,41,25,29,7,0,5,0.0,81.05921699880754,4,7,6,11,11,17,58.81033751683406,3.142857142857143,184.83248933862134,10.268471629923408,0.019603445838944685
0.9093660517385167,53,33,31,9,6,11,12.0,78.61771265675904,6,21,12,24,27,36,171.1759500778849,3.4285714285714284,586.8889716956053,32.60494287197807,0.05705865002596163
4.89169075846944,38,23,23,10,0,7,0.0,85.95270294103729,4,10,5,10,14,15,57.110323830864054,2.0,114.22064766172811,6.345591536762672,0.019036774610288017
3.6039194625908078,53,34,31,10,7,12,12.0,77.91664428445937,5,21,15,30,26,45,211.51978731634918,3.5714285714285716,755.4278118441042,41.9682117691169,0.07050659577211639
2.994726193578027,45,27,25,13,0,10,0.0,81.88078146131345,7,17,10,20,24,30,137.5488750216347,4.117647058823529,566.3777206773193,31.46542892651774,0.04584962500721157
2.7570066755888254,166,96,113,31,6,27,44.0,55.184202765687544,16,122,82,168,138,250,1777.1311141945425,11.01639344262295,19577.575553093975,1087.6430862829986,0.5923770380648475
2.599978695743248,63,37,46,9,0,13,10.0,72.46902515564568,5,17,11,22,22,33,147.1612434150308,3.235294117647059,476.1099051662762,26.450550287015343,0.04905374780501027
2.599978695743248,65,38,47,10,0,13,10.0,72.54766143270282,6,18,12,24,24,36,165.05865002596164,4.0,660.2346001038466,36.679700005769256,0.05501955000865388
2.5948315988836113,76,49,48,14,6,15,11.0,72.78473615948097,7,30,19,38,37,57,296.93884184085016,4.433333333333334,1316.4288654944357,73.13493697191309,0.09897961394695005
2.555690774819719,67,40,49,16,0,9,0.0,75.39435765169034,6,18,12,24,24,36,165.05865002596164,4.0,660.2346001038466,36.679700005769256,0.05501955000865388
2.465669506098432,62,42,42,15,0,11,0.0,74.37563218840313,8,23,15,29,31,44,217.98463765702255,5.043478260869565,1099.4007812267225,61.077821179262365,0.07266154588567418
2.3795529708725502,56,27,36,14,0,9,0.0,81.46127875001314,5,17,10,20,22,30,133.78294855911892,2.9411764705882355,393.4792604679969,21.859958914888715,0.044594316186372975
2.3790671295773826,55,35,35,12,0,10,0.0,77.16361572108632,6,20,12,24,26,36,169.21582985307933,3.6,609.1769874710856,33.843165970615864,0.05640527661769311
2.3790671295773826,67,41,49,7,0,14,3.5,71.23912709564955,3,12,7,14,15,21,82.0447025077789,1.75,143.57822938861307,7.9765682993673925,0.02734823416925963
2.3790671295773826,80,44,55,15,0,16,4.5,71.76492027592266,7,29,18,36,36,54,279.17595007788486,4.344827586206897,1212.9713693039137,67.38729829466187,0.09305865002596161
2.3790671295773826,54,32,29,8,6,11,8.0,81.53993987695885,4,13,7,14,17,21,85.83671966625714,2.1538461538461537,184.87908851193845,10.27106047288547,0.02861223988875238
2.3684875374464665,69,37,45,13,0,12,6.0,75.03797027192977,9,19,13,26,28,39,187.48684196024655,6.157894736842105,1154.5242373341498,64.14023540745276,0.06249561398674885
2.3308516138839384,73,39,47,19,0,12,3.0,78.40388731144624,6,15,9,18,21,27,118.59257041502654,3.6,426.93325349409554,23.718514083005307,0.03953085680500885
2.2300198512981466,49,34,34,14,0,8,0.0,81.0393562155881,5,11,6,12,16,18,72.0,2.727272727272727,196.36363636363635,10.909090909090908,0.024
2.2300198512981466,54,38,38,16,0,8,0.0,79.41757720066872,5,12,7,14,17,21,85.83671966625714,2.9166666666666665,250.3570990265833,13.908727723699073,0.02861223988875238
2.0063138640588503,42,27,25,10,0,9,0.0,81.53409693035718,5,14,9,18,19,27,114.6940428629768,3.2142857142857144,368.65942348813974,20.48107908267443,0.03823134762099227
1.9361677479266934,82,50,49,14,6,17,14.0,71.13589058779301,8,35,25,50,43,75,406.96985660265733,5.714285714285714,2325.5420377294704,129.19677987385947,0.13565661886755245
1.8432353376998099,47,34,31,12,0,8,5.0,79.59794505877524,4,14,8,16,18,24,100.07820003461549,2.2857142857142856,228.75017150769253,12.708342861538474,0.0333594000115385
1.7771073243143396,60,43,43,15,0,9,0.0,75.16293922486963,6,17,11,22,23,33,149.27754454988144,3.8823529411764706,579.5481141348338,32.19711745193521,0.04975918151662715
1.6675916849793366,55,37,36,4,6,10,7.0,77.86919204667477,5,10,6,12,15,18,70.32403072095333,3.0,210.97209216286,11.720671786825555,0.02344134357365111
1.6675916849793366,63,37,45,5,0,14,3.0,71.44606962078747,4,10,5,10,14,15,57.110323830864054,2.0,114.22064766172811,6.345591536762672,0.019036774610288017
1.6675916849793366,50,33,31,11,0,10,0.0,80.1314127648697,4,11,7,14,15,21,82.0447025077789,2.5454545454545454,208.84106092889172,11.602281162716206,0.02734823416925963
5.2148140080969645,73,40,52,11,0,14,10.0,71.97624170411959,6,19,12,24,25,36,167.17882283189007,3.789473684210526,633.5197496787413,35.19554164881896,0.05572627427729669
5.127218581110546,73,39,49,13,0,14,8.0,74.8949541465991,7,16,10,20,23,30,135.7068586817104,4.375,593.717506732483,32.98430592958239,0.04523561956057014
4.89169075846944,38,23,23,10,0,7,0.0,85.95270294103729,4,10,5,10,14,15,57.110323830864054,2.0,114.22064766172811,6.345591536762672,0.019036774610288017
4.89169075846944,56,38,36,13,0,11,0.0,77.27672711264704,6,16,10,20,22,30,133.78294855911892,3.75,501.68605709669595,27.87144761648311,0.044594316186372975
4.89169075846944,61,32,40,11,0,10,2.0,80.49830993955649,4,7,5,10,11,15,51.89147427955947,2.857142857142857,148.26135508445563,8.236741949136423,0.01729715809318649
4.89169075846944,80,42,52,14,0,16,7.0,74.2372535670924,6,15,11,22,21,33,144.94647495169912,4.4,637.7644897874761,35.431360543748674,0.048315491650566374
4.475847315384492,40,23,23,12,0,7,0.0,85.18198253757686,5,13,7,14,18,21,87.56842503028855,2.6923076923076925,235.76114431231534,13.097841350684185,0.029189475010096184
3.6039194625908078,53,34,31,10,7,12,12.0,77.91664428445937,5,21,15,30,26,45,211.51978731634918,3.5714285714285716,755.4278118441042,41.9682117691169,0.07050659577211639
3.393578855694097,48,29,29,12,0,8,0.0,81.13985339219118,6,16,9,18,22,27,120.40465370320703,3.375,406.3657062483237,22.57587256935132,0.04013488456773568
3.272579439001505,62,39,39,17,0,12,0.0,76.87459661145844,10,23,13,25,33,38,191.68697653562123,5.434782608695652,1041.777046389246,57.87650257718033,0.06389565884520708
3.1929503260501697,96,55,67,21,0,16,13.0,67.31825285246917,9,51,38,75,60,113,667.4786373037626,6.617647058823529,4417.138040980782,245.39655783226564,0.2224928791012542
3.1929503260501697,62,45,46,17,0,12,18.0,71.35075300274411,6,30,24,48,36,72,372.23460010384645,4.8,1786.7260804984628,99.26256002769237,0.12407820003461548
3.1739229166980913,78,46,54,16,0,12,10.0,71.29153904433878,9,25,19,38,34,57,289.9853819512694,6.84,1983.5000125466827,110.19444514148238,0.09666179398375646
3.1530203120841596,156,96,114,32,0,25,0.0,54.76092303851894,15,127,90,184,142,274,1959.030710744283,10.866141732283465,21287.10536084339,1182.6169644912995,0.653010236914761
3.1264159455558955,176,101,122,33,0,29,0.0,53.2273688454588,16,128,85,174,144,259,1857.010575373559,10.875,20194.990007187454,1121.943889288192,0.6190035251245197
2.994726193578027,45,27,25,13,0,10,0.0,81.88078146131345,7,17,10,20,24,30,137.5488750216347,4.117647058823529,566.3777206773193,31.46542892651774,0.04584962500721157
2.8995624757572944,65,34,42,11,0,12,4.0,76.36632315056288,7,16,10,20,23,30,135.7068586817104,4.375,593.717506732483,32.98430592958239,0.04523561956057014
2.812390820346396,46,30,28,15,0,9,0.0,80.97060324521858,5,15,10,20,20,30,129.65784284662087,3.3333333333333335,432.19280948873626,24.010711638263125,0.043219280948873624
2.7570066755888254,166,96,113,31,6,27,44.0,55.184202765687544,16,122,82,168,138,250,1777.1311141945425,11.01639344262295,19577.575553093975,1087.6430862829986,0.5923770380648475
2.7007165541047797,59,31,40,13,0,10,0.0,77.69331817995442,8,19,13,26,27,39,185.4406125843753,5.473684210526316,1015.0433530934226,56.39129739407903,0.061813537528125094
2.6947223221957617,55,40,40,14,0,8,0.0,75.48705423956281,7,19,12,24,26,36,169.21582985307933,4.421052631578948,748.1120898767718,41.56178277093177,0.05640527661769311
2.611019720685997,194,124,141,25,4,27,55.0,46.42151334643967,17,179,120,246,196,366,2786.9838029461657,11.681564245810057,32556.330346147668,1808.685019230426,0.9289946009820552
2.599978695743248,63,37,46,9,0,13,10.0,72.46902515564568,5,17,11,22,22,33,147.1612434150308,3.235294117647059,476.1099051662762,26.450550287015343,0.04905374780501027
2.599978695743248,65,38,47,10,0,13,10.0,72.54766143270282,6,18,12,24,24,36,165.05865002596164,4.0,660.2346001038466,36.679700005769256,0.05501955000865388
2.599978695743248,65,39,48,10,0,13,12.0,71.35495671601025,5,20,14,28,25,42,195.04195997053841,3.5,682.6468598968845,37.92482554982692,0.06501398665684614
5.2148140080969645,73,40,52,11,0,14,10.0,71.97624170411959,6,19,12,24,25,36,167.17882283189007,3.789473684210526,633.5197496787413,35.19554164881896,0.05572627427729669
5.127218581110546,73,39,49,13,0,14,8.0,74.8949541465991,7,16,10,20,23,30,135.7068586817104,4.375,593.717506732483,32.98430592958239,0.04523561956057014
5.127218581110546,73,39,49,13,0,14,8.0,74.8949541465991,7,16,10,20,23,30,135.7068586817104,4.375,593.717506732483,32.98430592958239,0.04523561956057014
4.89169075846944,38,23,23,10,0,7,0.0,85.95270294103729,4,10,5,10,14,15,57.110323830864054,2.0,114.22064766172811,6.345591536762672,0.019036774610288017
4.89169075846944,56,38,36,13,0,11,0.0,77.27672711264704,6,16,10,20,22,30,133.78294855911892,3.75,501.68605709669595,27.87144761648311,0.044594316186372975
4.89169075846944,61,32,40,11,0,10,2.0,80.49830993955649,4,7,5,10,11,15,51.89147427955947,2.857142857142857,148.26135508445563,8.236741949136423,0.01729715809318649
4.89169075846944,80,42,52,14,0,16,7.0,74.2372535670924,6,15,11,22,21,33,144.94647495169912,4.4,637.7644897874761,35.431360543748674,0.048315491650566374
4.89169075846944,87,59,57,26,0,16,0.0,70.30030745812154,10,35,25,49,45,74,406.39712912839593,7.0,2844.7799038987714,158.0433279943762,0.1354657097094653
4.89169075846944,64,45,43,20,0,11,0.0,75.94108051089404,6,18,12,24,24,36,165.05865002596164,4.0,660.2346001038466,36.679700005769256,0.05501955000865388
4.861945714497812,54,35,35,19,0,9,0.0,76.33407398524938,8,28,20,40,36,60,310.19550008653874,5.714285714285714,1772.5457147802215,98.47476193223453,0.10339850002884625
4.85325910036141,59,42,43,12,0,11,15.0,71.3183021883838,5,29,19,38,34,57,289.9853819512694,3.2758620689655173,949.9521132886412,52.77511740492451,0.09666179398375646
4.765077909120132,57,35,37,17,0,9,0.0,76.77138170426755,9,25,17,34,34,51,259.4606049037673,6.12,1587.898902011056,88.21660566728089,0.08648686830125578
4.475847315384492,40,23,23,12,0,7,0.0,85.18198253757686,5,13,7,14,18,21,87.56842503028855,2.6923076923076925,235.76114431231534,13.097841350684185,0.029189475010096184
4.322891015484403,65,33,42,17,0,12,0.0,78.29888712342962,8,21,13,26,29,39,189.46125880997533,4.9523809523809526,938.2843293446398,52.12690718581332,0.06315375293665844
3.6686377934102508,81,41,51,12,0,18,10.0,72.31154036585308,7,19,13,26,26,39,183.31714900750262,4.7894736842105265,877.9926610359337,48.77737005755187,0.061105716335834205
3.6039194625908078,53,34,31,10,7,12,12.0,77.91664428445937,5,21,15,30,26,45,211.51978731634918,3.5714285714285716,755.4278118441042,41.9682117691169,0.07050659577211639
3.393578855694097,48,29,29,12,0,8,0.0,81.13985339219118,6,16,9,18,22,27,120.40465370320703,3.375,406.3657062483237,22.57587256935132,0.04013488456773568
3.272579439001505,62,39,39,17,0,12,0.0,76.87459661145844,10,23,13,25,33,38,191.68697653562123,5.434782608695652,1041.777046389246,57.87650257718033,0.06389565884520708
3.272579439001505,95,62,61,29,0,16,4.0,68.8029096730969,12,46,30,59,58,89,521.3603085663539,7.695652173913044,4012.2075920106363,222.9004217783687,0.17378676952211797
3.1929503260501697,96,55,67,21,0,16,13.0,67.31825285246917,9,51,38,75,60,113,667.4786373037626,6.617647058823529,4417.138040980782,245.39655783226564,0.2224928791012542
3.1929503260501697,62,45,46,17,0,12,18.0,71.35075300274411,6,30,24,48,36,72,372.23460010384645,4.8,1786.7260804984628,99.26256002769237,0.12407820003461548
3.1929503260501697,64,47,48,19,0,12,20.0,70.61122955388943,6,33,27,54,39,81,428.11757972784216,4.909090909090909,2101.6681186639526,116.75933992577514,0.14270585990928072
3.1739229166980913,78,46,54,16,0,12,10.0,71.29153904433878,9,25,19,38,34,57,289.9853819512694,6.84,1983.5000125466827,110.19444514148238,0.09666179398375646
3.1739229166980913,67,46,43,16,0,12,10.0,72.74709221264466,9,25,19,38,34,57,289.9853819512694,6.84,1983.5000125466827,110.19444514148238,0.09666179398375646
3.1530203120841596,156,96,114,32,0,25,0.0,54.76092303851894,15,127,90,184,142,274,1959.030710744283,10.866141732283465,21287.10536084339,1182.6169644912995,0.653010236914761
6.78008301784965,51,33,33,17,0,9,0.0,77.65584574586359,8,25,17,34,33,51,257.2641000872811,5.44,1399.5167044748093,77.75092802637829,0.0857547000290937
5.2148140080969645,73,40,52,11,0,14,10.0,71.97624170411959,6,19,12,24,25,36,167.17882283189007,3.789473684210526,633.5197496787413,35.19554164881896,0.05572627427729669
5.127218581110546,73,39,49,13,0,14,8.0,74.8949541465991,7,16,10,20,23,30,135.7068586817104,4.375,593.717506732483,32.98430592958239,0.04523561956057014
5.127218581110546,73,39,49,13,0,14,8.0,74.8949541465991,7,16,10,20,23,30,135.7068586817104,4.375,593.717506732483,32.98430592958239,0.04523561956057014
5.026731225252669,56,32,29,10,7,13,7.0,80.2159644198841,7,19,11,21,26,32,150.41407098051496,3.8684210526315788,581.8649587930447,32.32583104405804,0.05013802366017166
4.89169075846944,38,23,23,10,0,7,0.0,85.95270294103729,4,10,5,10,14,15,57.110323830864054,2.0,114.22064766172811,6.345591536762672,0.019036774610288017
4.89169075846944,56,38,36,13,0,11,0.0,77.27672711264704,6,16,10,20,22,30,133.78294855911892,3.75,501.68605709669595,27.87144761648311,0.044594316186372975
4.89169075846944,61,32,40,11,0,10,2.0,80.49830993955649,4,7,5,10,11,15,51.89147427955947,2.857142857142857,148.26135508445563,8.236741949136423,0.01729715809318649
4.89169075846944,80,42,52,14,0,16,7.0,74.2372535670924,6,15,11,22,21,33,144.94647495169912,4.4,637.7644897874761,35.431360543748674,0.048315491650566374
4.89169075846944,87,59,57,26,0,16,0.0,70.30030745812154,10,35,25,49,45,74,406.39712912839593,7.0,2844.7799038987714,158.0433279943762,0.1354657097094653
4.89169075846944,64,45,43,20,0,11,0.0,75.94108051089404,6,18,12,24,24,36,165.05865002596164,4.0,660.2346001038466,36.679700005769256,0.05501955000865388
4.89169075846944,58,38,36,19,0,11,0.0,77.86666608452266,8,19,12,24,27,36,171.1759500778849,5.052631578947368,864.8890109198394,48.049389495546635,0.05705865002596163
4.861945714497812,54,35,35,19,0,9,0.0,76.33407398524938,8,28,20,40,36,60,310.19550008653874,5.714285714285714,1772.5457147802215,98.47476193223453,0.10339850002884625
4.85325910036141,59,42,43,12,0,11,15.0,71.3183021883838,5,29,19,38,34,57,289.9853819512694,3.2758620689655173,949.9521132886412,52.77511740492451,0.09666179398375646
4.765077909120132,57,35,37,17,0,9,0.0,76.77138170426755,9,25,17,34,34,51,259.4606049037673,6.12,1587.898902011056,88.21660566728089,0.08648686830125578
4.548450882090423,72,48,48,25,0,13,0.0,71.90680581058739,11,36,26,51,47,77,427.7033415791781,7.791666666666667,3332.521869804429,185.14010387802384,0.14256778052639268
4.475847315384492,40,23,23,12,0,7,0.0,85.18198253757686,5,13,7,14,18,21,87.56842503028855,2.6923076923076925,235.76114431231534,13.097841350684185,0.029189475010096184
4.322891015484403,65,33,42,17,0,12,0.0,78.29888712342962,8,21,13,26,29,39,189.46125880997533,4.9523809523809526,938.2843293446398,52.12690718581332,0.06315375293665844
4.2913157410760805,86,46,56,18,0,15,9.0,73.29159407924645,8,22,14,28,30,42,206.0894050155578,5.090909090909091,1049.1824255337488,58.28791252965271,0.06869646833851926
4.045519860320544,68,35,45,9,0,15,7.0,74.69416781567826,6,13,8,16,19,24,101.95026032264605,3.6923076923076925,376.43173042207775,20.912873912337652,0.03398342010754868
3.812640188024219,97,67,65,32,0,17,0.0,67.40144844939465,12,44,34,67,56,101,586.542847127818,9.136363636363637,5358.868739667792,297.714929981544,0.19551428237593935
3.6686377934102508,81,41,51,12,0,18,10.0,72.31154036585308,7,19,13,26,26,39,183.31714900750262,4.7894736842105265,877.9926610359337,48.77737005755187,0.061105716335834205
3.6039194625908078,53,34,31,10,7,12,12.0,77.91664428445937,5,21,15,30,26,45,211.51978731634918,3.5714285714285716,755.4278118441042,41.9682117691169,0.07050659577211639
3.393578855694097,48,29,29,12,0,8,0.0,81.13985339219118,6,16,9,18,22,27,120.40465370320703,3.375,406.3657062483237,22.57587256935132,0.04013488456773568
3.272579439001505,62,39,39,17,0,12,0.0,76.87459661145844,10,23,13,25,33,38,191.68697653562123,5.434782608695652,1041.777046389246,57.87650257718033,0.06389565884520708
7.428397518917852,81,41,51,15,0,16,8.0,75.58640750659308,6,15,9,18,21,27,118.59257041502654,3.6,426.93325349409554,23.718514083005307,0.03953085680500885
7.344784073489383,76,41,51,13,0,15,8.0,74.1172729820989,7,16,10,20,23,30,135.7068586817104,4.375,593.717506732483,32.98430592958239,0.04523561956057014
7.344784073489383,66,36,48,10,0,11,8.0,74.11808292855636,7,15,9,18,22,27,120.40465370320703,4.2,505.69954555346953,28.094419197414975,0.04013488456773568
7.09448616551143,115,62,82,21,0,19,0.0,65.50972940719883,11,40,25,51,51,76,431.1043259898337,7.0125,3023.1190860037086,167.95106033353937,0.14370144199661122
6.78008301784965,51,33,33,17,0,9,0.0,77.65584574586359,8,25,17,34,33,51,257.2641000872811,5.44,1399.5167044748093,77.75092802637829,0.0857547000290937
6.78008301784965,74,41,51,14,0,14,11.0,72.3272864481366,8,25,17,34,33,51,257.2641000872811,5.44,1399.5167044748093,77.75092802637829,0.0857547000290937
5.767127027452535,62,35,35,20,0,14,0.0,77.38454815969448,8,25,16,32,33,48,242.13091772920575,5.12,1239.7102987735334,68.87279437630741,0.08071030590973526
5.66705710388567,68,35,45,9,0,15,7.0,74.69416781567826,6,13,8,16,19,24,101.95026032264605,3.6923076923076925,376.43173042207775,20.912873912337652,0.03398342010754868
5.525648460663531,60,39,40,10,0,12,9.0,72.8111677032273,9,24,15,29,33,44,221.95334125177195,5.4375,1206.87129305651,67.04840516980612,0.07398444708392399
5.510917826422662,50,33,33,16,0,9,0.0,76.94980811322182,8,28,20,40,36,60,310.19550008653874,5.714285714285714,1772.5457147802215,98.47476193223453,0.10339850002884625
5.382097071164624,58,35,37,18,0,9,0.0,76.8955834719346,9,27,17,34,36,51,263.6661750735579,5.666666666666667,1494.1083254168282,83.00601807871267,0.0878887250245193
5.2772989540555555,62,40,37,14,7,12,13.0,75.30589685036688,8,28,19,37,36,56,289.5158000807695,5.285714285714286,1530.2978004269246,85.01654446816248,0.09650526669358983
5.216558633470512,74,41,51,10,0,15,10.0,70.49012707858127,8,22,14,28,30,42,206.0894050155578,5.090909090909091,1049.1824255337488,58.28791252965271,0.06869646833851926
5.2148140080969645,73,40,52,11,0,14,10.0,71.97624170411959,6,19,12,24,25,36,167.17882283189007,3.789473684210526,633.5197496787413,35.19554164881896,0.05572627427729669
5.127218581110546,73,39,49,13,0,14,8.0,74.8949541465991,7,16,10,20,23,30,135.7068586817104,4.375,593.717506732483,32.98430592958239,0.04523561956057014
5.127218581110546,73,39,49,13,0,14,8.0,74.8949541465991,7,16,10,20,23,30,135.7068586817104,4.375,593.717506732483,32.98430592958239,0.04523561956057014
5.127218581110546,65,33,39,8,9,11,8.0,79.5074518773051,7,16,10,20,23,30,135.7068586817104,4.375,593.717506732483,32.98430592958239,0.04523561956057014
5.127218581110546,73,39,49,13,0,14,8.0,74.8949541465991,7,16,10,20,23,30,135.7068586817104,4.375,593.717506732483,32.98430592958239,0.04523561956057014
5.059638453697224,100,68,66,34,0,18,0.0,67.25633467922313,12,45,35,69,57,104,606.6205614731332,9.2,5580.909165552825,310.05050919737914,0.20220685382437772
5.026731225252669,56,32,29,10,7,13,7.0,80.2159644198841,7,19,11,21,26,32,150.41407098051496,3.8684210526315788,581.8649587930447,32.32583104405804,0.05013802366017166
4.978089533121524,88,46,56,21,0,15,9.0,73.74222178616319,9,24,16,32,33,48,242.13091772920575,6.0,1452.7855063752345,80.71030590973525,0.08071030590973526
4.946078401924979,88,65,66,24,0,13,21.0,66.45790566539175,8,40,30,60,48,90,502.64662506490413,6.0,3015.8797503894248,167.5488750216347,0.1675488750216347
4.932706610069474,53,35,35,18,0,9,0.0,75.41311592594128,9,35,25,50,44,75,409.4573713977973,6.428571428571429,2632.22595898584,146.23477549921333,0.13648579046593243
4.932054895339847,69,42,42,18,0,14,0.0,74.07438330657907,9,34,21,42,43,63,341.85467954623215,5.5588235294117645,1900.3098363011138,105.57276868339521,0.11395155984874406
4.89169075846944,38,23,23,10,0,7,0.0,85.95270294103729,4,10,5,10,14,15,57.110323830864054,2.0,114.22064766172811,6.345591536762672,0.019036774610288017
7.428397518917852,81,41,51,15,0,16,8.0,75.58640750659308,6,15,9,18,21,27,118.59257041502654,3.6,426.93325349409554,23.718514083005307,0.03953085680500885
7.428397518917852,75,40,50,10,0,15,8.0,72.83481444198962,6,15,9,18,21,27,118.59257041502654,3.6,426.93325349409554,23.718514083005307,0.03953085680500885
7.428397518917852,74,39,49,13,0,15,7.0,75.95555951770902,5,13,8,16,18,24,100.07820003461549,3.076923076923077,307.9329231834323,17.107384621301794,0.0333594000115385
7.344784073489383,76,41,51,13,0,15,8.0,74.1172729820989,7,16,10,20,23,30,135.7068586817104,4.375,593.717506732483,32.98430592958239,0.04523561956057014
7.344784073489383,66,36,48,10,0,11,8.0,74.11808292855636,7,15,9,18,22,27,120.40465370320703,4.2,505.69954555346953,28.094419197414975,0.04013488456773568
7.344784073489383,77,41,51,13,0,16,8.0,74.1172729820989,7,16,10,20,23,30,135.7068586817104,4.375,593.717506732483,32.98430592958239,0.04523561956057014
7.09448616551143,115,62,82,21,0,19,0.0,65.50972940719883,11,40,25,51,51,76,431.1043259898337,7.0125,3023.1190860037086,167.95106033353937,0.14370144199661122
7.09448616551143,107,56,72,24,0,19,0.0,68.35989163812098,11,39,25,51,50,76,428.93307042287904,7.1923076923076925,3085.01862188763,171.38992343820166,0.14297769014095968
6.78008301784965,51,33,33,17,0,9,0.0,77.65584574586359,8,25,17,34,33,51,257.2641000872811,5.44,1399.5167044748093,77.75092802637829,0.0857547000290937
6.78008301784965,74,41,51,14,0,14,11.0,72.3272864481366,8,25,17,34,33,51,257.2641000872811,5.44,1399.5167044748093,77.75092802637829,0.0857547000290937
6.573716383725214,88,46,56,21,0,15,9.0,73.74222178616319,9,24,16,32,33,48,242.13091772920575,6.0,1452.7855063752345,80.71030590973525,0.08071030590973526
5.767127027452535,62,35,35,20,0,14,0.0,77.38454815969448,8,25,16,32,33,48,242.13091772920575,5.12,1239.7102987735334,68.87279437630741,0.08071030590973526
5.66705710388567,68,35,45,9,0,15,7.0,74.69416781567826,6,13,8,16,19,24,101.95026032264605,3.6923076923076925,376.43173042207775,20.912873912337652,0.03398342010754868
5.525648460663531,60,39,40,10,0,12,9.0,72.8111677032273,9,24,15,29,33,44,221.95334125177195,5.4375,1206.87129305651,67.04840516980612,0.07398444708392399
5.510917826422662,50,33,33,16,0,9,0.0,76.94980811322182,8,28,20,40,36,60,310.19550008653874,5.714285714285714,1772.5457147802215,98.47476193223453,0.10339850002884625
5.382097071164624,58,35,37,18,0,9,0.0,76.8955834719346,9,27,17,34,36,51,263.6661750735579,5.666666666666667,1494.1083254168282,83.00601807871267,0.0878887250245193
5.2772989540555555,62,40,37,14,7,12,13.0,75.30589685036688,8,28,19,37,36,56,289.5158000807695,5.285714285714286,1530.2978004269246,85.01654446816248,0.09650526669358983
5.216558633470512,74,41,51,10,0,15,10.0,70.49012707858127,8,22,14,28,30,42,206.0894050155578,5.090909090909091,1049.1824255337488,58.28791252965271,0.06869646833851926
5.2148140080969645,73,40,52,11,0,14,10.0,71.97624170411959,6,19,12,24,25,36,167.17882283189007,3.789473684210526,633.5197496787413,35.19554164881896,0.05572627427729669
5.127218581110546,73,39,49,13,0,14,8.0,74.8949541465991,7,16,10,20,23,30,135.7068586817104,4.375,593.717506732483,32.98430592958239,0.04523561956057014
5.127218581110546,73,39,49,13,0,14,8.0,74.8949541465991,7,16,10,20,23,30,135.7068586817104,4.375,593.717506732483,32.98430592958239,0.04523561956057014
5.127218581110546,65,33,39,8,9,11,8.0,79.5074518773051,7,16,10,20,23,30,135.7068586817104,4.375,593.717506732483,32.98430592958239,0.04523561956057014
5.127218581110546,73,39,49,13,0,14,8.0,74.8949541465991,7,16,10,20,23,30,135.7068586817104,4.375,593.717506732483,32.98430592958239,0.04523561956057014
5.059638453697224,100,68,66,34,0,18,0.0,67.25633467922313,12,45,35,69,57,104,606.6205614731332,9.2,5580.909165552825,310.05050919737914,0.20220685382437772
5.026731225252669,56,32,29,10,7,13,7.0,80.2159644198841,7,19,11,21,26,32,150.41407098051496,3.8684210526315788,581.8649587930447,32.32583104405804,0.05013802366017166
9.429771568065943,81,43,53,16,0,17,12.0,72.85405114056049,6,23,15,31,29,46,223.46712577586834,4.043478260869565,903.5844650937286,50.19913694965159,0.07448904192528945
9.429771568065943,80,43,53,14,3,16,11.0,73.7432784141245,6,21,14,28,27,42,199.7052750908657,4.0,798.8211003634628,44.37895002019238,0.06656842503028856
8.798589603280824,71,34,40,14,9,12,6.0,80.5025419867652,6,15,9,18,21,27,118.59257041502654,3.6,426.93325349409554,23.718514083005307,0.03953085680500885
7.428397518917852,81,41,51,15,0,16,8.0,75.58640750659308,6,15,9,18,21,27,118.59257041502654,3.6,426.93325349409554,23.718514083005307,0.03953085680500885
7.428397518917852,75,40,50,10,0,15,8.0,72.83481444198962,6,15,9,18,21,27,118.59257041502654,3.6,426.93325349409554,23.718514083005307,0.03953085680500885
7.428397518917852,74,39,49,13,0,15,7.0,75.95555951770902,5,13,8,16,18,24,100.07820003461549,3.076923076923077,307.9329231834323,17.107384621301794,0.0333594000115385
7.428397518917852,73,37,49,14,0,14,9.0,74.26914750121452,8,24,15,30,32,45,225.0,5.0,1125.0,62.5,0.075
7.344784073489383,76,41,51,13,0,15,8.0,74.1172729820989,7,16,10,20,23,30,135.7068586817104,4.375,593.717506732483,32.98430592958239,0.04523561956057014
7.344784073489383,66,36,48,10,0,11,8.0,74.11808292855636,7,15,9,18,22,27,120.40465370320703,4.2,505.69954555346953,28.094419197414975,0.04013488456773568
7.344784073489383,77,41,51,13,0,16,8.0,74.1172729820989,7,16,10,20,23,30,135.7068586817104,4.375,593.717506732483,32.98430592958239,0.04523561956057014
7.344784073489383,72,38,48,15,0,14,9.0,75.8933313031593,6,17,11,22,23,33,149.27754454988144,3.8823529411764706,579.5481141348338,32.19711745193521,0.04975918151662715
7.344784073489383,74,40,50,12,0,15,8.0,74.20485079941177,7,16,9,18,23,27,122.13617281353935,3.9375,480.9111804533112,26.717287802961735,0.040712057604513116
7.09448616551143,115,62,82,21,0,19,0.0,65.50972940719883,11,40,25,51,51,76,431.1043259898337,7.0125,3023.1190860037086,167.95106033353937,0.14370144199661122
7.09448616551143,107,56,72,24,0,19,0.0,68.35989163812098,11,39,25,51,50,76,428.93307042287904,7.1923076923076925,3085.01862188763,171.38992343820166,0.14297769014095968
7.09448616551143,108,56,72,26,0,19,0.0,69.30993043313109,11,37,23,46,48,69,385.3624125497598,6.837837837837838,2635.0456858132225,146.39142698962348,0.1284541375165866
7.09448616551143,108,56,72,24,0,19,0.0,67.84088048868641,11,44,29,59,55,88,508.7596547901701,7.375,3752.1024540775043,208.45013633763912,0.16958655159672337
6.821997407952237,77,43,53,16,0,14,12.0,72.03679104387547,8,27,19,38,35,57,292.36913196586306,5.62962962962963,1645.929928104118,91.44055156133989,0.09745637732195435
6.78008301784965,51,33,33,17,0,9,0.0,77.65584574586359,8,25,17,34,33,51,257.2641000872811,5.44,1399.5167044748093,77.75092802637829,0.0857547000290937
6.78008301784965,74,41,51,14,0,14,11.0,72.3272864481366,8,25,17,34,33,51,257.2641000872811,5.44,1399.5167044748093,77.75092802637829,0.0857547000290937
6.573716383725214,88,46,56,21,0,15,9.0,73.74222178616319,9,24,16,32,33,48,242.13091772920575,6.0,1452.7855063752345,80.71030590973525,0.08071030590973526
6.573716383725214,67,38,40,20,0,11,0.0,76.5016095563727,9,25,17,34,34,51,259.4606049037673,6.12,1587.898902011056,88.21660566728089,0.08648686830125578
6.306338882430523,57,36,37,11,0,13,6.0,76.44076323891323,7,19,11,21,26,32,150.41407098051496,3.8684210526315788,581.8649587930447,32.32583104405804,0.05013802366017166
5.767127027452535,62,35,35,20,0,14,0.0,77.38454815969448,8,25,16,32,33,48,242.13091772920575,5.12,1239.7102987735334,68.87279437630741,0.08071030590973526
5.767127027452535,61,35,35,20,0,13,0.0,77.38454815969448,8,25,16,32,33,48,242.13091772920575,5.12,1239.7102987735334,68.87279437630741,0.08071030590973526
5.709205835675636,71,38,48,12,0,14,8.0,74.45054754421467,8,16,11,21,24,32,146.71880002307702,5.25,770.2737001211543,42.792983340064126,0.04890626667435901
9.429771568065943,81,43,53,16,0,17,12.0,72.85405114056049,6,23,15,31,29,46,223.46712577586834,4.043478260869565,903.5844650937286,50.19913694965159,0.07448904192528945
9.429771568065943,80,43,53,14,3,16,11.0,73.7432784141245,6,21,14,28,27,42,199.7052750908657,4.0,798.8211003634628,44.37895002019238,0.06656842503028856
9.429771568065943,81,43,53,16,0,17,12.0,72.85405114056049,6,23,15,31,29,46,223.46712577586834,4.043478260869565,903.5844650937286,50.19913694965159,0.07448904192528945
9.429771568065943,80,43,53,14,3,16,11.0,73.7432784141245,6,21,14,28,27,42,199.7052750908657,4.0,798.8211003634628,44.37895002019238,0.06656842503028856
9.429771568065943,78,41,51,14,0,17,10.0,73.68923317893025,6,19,12,25,25,37,171.8226790216648,3.9473684210526314,678.2474171907821,37.68041206615456,0.057274226340554936
9.429771568065943,78,42,52,17,0,15,9.0,75.67406101722455,5,15,10,20,20,30,129.65784284662087,3.3333333333333335,432.19280948873626,24.010711638263125,0.043219280948873624
9.116731998629414,116,63,79,29,0,19,0.0,66.85868635460709,11,45,31,62,56,93,540.0840077513573,7.5777777777777775,4092.636592071396,227.368699559522,0.18002800258378576
8.798589603280824,71,34,40,14,9,12,6.0,80.5025419867652,6,15,9,18,21,27,118.59257041502654,3.6,426.93325349409554,23.718514083005307,0.03953085680500885
8.798589603280824,70,34,40,14,9,11,6.0,80.5025419867652,6,15,9,18,21,27,118.59257041502654,3.6,426.93325349409554,23.718514083005307,0.03953085680500885
8.798589603280824,71,34,40,15,9,12,6.0,80.48541751555261,6,15,9,18,21,27,118.59257041502654,3.6,426.93325349409554,23.718514083005307,0.03953085680500885
8.013096599708255,48,28,28,12,0,11,0.0,79.91012612071465,7,20,13,26,27,39,185.4406125843753,4.55,843.7547872589075,46.875265958828194,0.061813537528125094
7.6266187762094,73,40,49,19,0,12,0.0,72.99604731158918,9,38,27,53,47,80,444.367108134211,6.276315789473684,2788.9882971055085,154.94379428363936,0.14812236937807033
7.428397518917852,81,41,51,15,0,16,8.0,75.58640750659308,6,15,9,18,21,27,118.59257041502654,3.6,426.93325349409554,23.718514083005307,0.03953085680500885
7.428397518917852,75,40,50,10,0,15,8.0,72.83481444198962,6,15,9,18,21,27,118.59257041502654,3.6,426.93325349409554,23.718514083005307,0.03953085680500885
7.428397518917852,74,39,49,13,0,15,7.0,75.95555951770902,5,13,8,16,18,24,100.07820003461549,3.076923076923077,307.9329231834323,17.107384621301794,0.0333594000115385
7.428397518917852,73,37,49,14,0,14,9.0,74.26914750121452,8,24,15,30,32,45,225.0,5.0,1125.0,62.5,0.075
7.428397518917852,72,38,50,9,0,13,9.0,70.37772539932843,8,24,15,30,32,45,225.0,5.0,1125.0,62.5,0.075
7.428397518917852,81,43,53,15,0,16,10.0,73.50857962736168,7,19,12,24,26,36,169.21582985307933,4.421052631578948,748.1120898767718,41.56178277093177,0.05640527661769311
7.428397518917852,112,58,74,29,0,21,0.0,69.2236637637998,10,35,25,50,45,75,411.8889822247256,7.142857142857143,2942.0641587480404,163.44800881933557,0.13729632740824188
7.428397518917852,81,41,51,15,0,16,8.0,75.58640750659308,6,15,9,18,21,27,118.59257041502654,3.6,426.93325349409554,23.718514083005307,0.03953085680500885
7.428397518917852,81,42,48,17,9,14,8.0,76.84159537377718,7,20,13,26,27,39,185.4406125843753,4.55,843.7547872589075,46.875265958828194,0.061813537528125094
7.374419612568593,68,43,44,16,0,14,12.0,73.0785968782617,8,29,20,39,37,59,307.35774857210805,5.379310344827586,1653.3727164568572,91.85403980315874,0.10245258285736936
7.344784073489383,76,41,51,13,0,15,8.0,74.1172729820989,7,16,10,20,23,30,135.7068586817104,4.375,593.717506732483,32.98430592958239,0.04523561956057014
7.344784073489383,66,36,48,10,0,11,8.0,74.11808292855636,7,15,9,18,22,27,120.40465370320703,4.2,505.69954555346953,28.094419197414975,0.04013488456773568
7.344784073489383,77,41,51,13,0,16,8.0,74.1172729820989,7,16,10,20,23,30,135.7068586817104,4.375,593.717506732483,32.98430592958239,0.04523561956057014
11.97929059417201,117,63,79,30,0,19,0.0,67.06055433366747,11,44,31,62,55,93,537.6664533577933,7.75,4166.915013522898,231.4952785290499,0.17922215111926446
9.429771568065943,81,43,53,16,0,17,12.0,72.85405114056049,6,23,15,31,29,46,223.46712577586834,4.043478260869565,903.5844650937286,50.19913694965159,0.07448904192528945
9.429771568065943,80,43,53,14,3,16,11.0,73.7432784141245,6,21,14,28,27,42,199.7052750908657,4.0,798.8211003634628,44.37895002019238,0.06656842503028856
9.429771568065943,81,43,53,16,0,17,12.0,72.85405114056049,6,23,15,31,29,46,223.46712577586834,4.043478260869565,903.5844650937286,50.19913694965159,0.07448904192528945
9.429771568065943,80,43,53,14,3,16,11.0,73.7432784141245,6,21,14,28,27,42,199.7052750908657,4.0,798.8211003634628,44.37895002019238,0.06656842503028856
9.429771568065943,78,41,51,14,0,17,10.0,73.68923317893025,6,19,12,25,25,37,171.8226790216648,3.9473684210526314,678.2474171907821,37.68041206615456,0.057274226340554936
9.429771568065943,78,42,52,17,0,15,9.0,75.67406101722455,5,15,10,20,20,30,129.65784284662087,3.3333333333333335,432.19280948873626,24.010711638263125,0.043219280948873624
9.429771568065943,81,43,53,16,0,17,14.0,71.690898062823,7,29,19,39,36,58,299.8556500836541,4.706896551724138,1411.3895253937512,78.41052918854173,0.09995188336121803
9.429771568065943,87,46,56,16,0,18,14.0,71.18195167687502,6,23,17,35,29,52,252.6150117466338,4.565217391304348,1153.2424449302846,64.06902471834914,0.0842050039155446
9.429771568065943,81,43,53,16,0,17,12.0,72.85405114056049,6,23,15,31,29,46,223.46712577586834,4.043478260869565,903.5844650937286,50.19913694965159,0.07448904192528945
9.116731998629414,116,63,79,29,0,19,0.0,66.85868635460709,11,45,31,62,56,93,540.0840077513573,7.5777777777777775,4092.636592071396,227.368699559522,0.18002800258378576
9.111160340929356,62,38,39,13,0,14,10.0,74.53897000720922,8,27,17,33,35,50,256.46415084724833,4.888888888888889,1253.8247374754365,69.65692985974647,0.08548805028241611
8.798589603280824,71,34,40,14,9,12,6.0,80.5025419867652,6,15,9,18,21,27,118.59257041502654,3.6,426.93325349409554,23.718514083005307,0.03953085680500885
8.798589603280824,70,34,40,14,9,11,6.0,80.5025419867652,6,15,9,18,21,27,118.59257041502654,3.6,426.93325349409554,23.718514083005307,0.03953085680500885
8.798589603280824,71,34,40,15,9,12,6.0,80.48541751555261,6,15,9,18,21,27,118.59257041502654,3.6,426.93325349409554,23.718514083005307,0.03953085680500885
8.798589603280824,74,38,44,13,9,15,7.0,78.37182683843126,7,18,11,22,25,33,153.24725426256592,4.277777777777778,655.5576987898653,36.41987215499252,0.05108241808752197
8.013096599708255,48,28,28,12,0,11,0.0,79.91012612071465,7,20,13,26,27,39,185.4406125843753,4.55,843.7547872589075,46.875265958828194,0.061813537528125094
7.6266187762094,73,40,49,19,0,12,0.0,72.99604731158918,9,38,27,53,47,80,444.367108134211,6.276315789473684,2788.9882971055085,154.94379428363936,0.14812236937807033
7.6266187762094,72,39,48,15,0,12,0.0,71.28487201602401,9,41,30,59,50,89,502.30320088995046,6.475609756097561,3252.719508201996,180.70663934455536,0.16743440029665016
7.428397518917852,81,41,51,15,0,16,8.0,75.58640750659308,6,15,9,18,21,27,118.59257041502654,3.6,426.93325349409554,23.718514083005307,0.03953085680500885
7.428397518917852,75,40,50,10,0,15,8.0,72.83481444198962,6,15,9,18,21,27,118.59257041502654,3.6,426.93325349409554,23.718514083005307,0.03953085680500885
7.428397518917852,74,39,49,13,0,15,7.0,75.95555951770902,5,13,8,16,18,24,100.07820003461549,3.076923076923077,307.9329231834323,17.107384621301794,0.0333594000115385
7.428397518917852,73,37,49,14,0,14,9.0,74.26914750121452,8,24,15,30,32,45,225.0,5.0,1125.0,62.5,0.075
7.428397518917852,72,38,50,9,0,13,9.0,70.37772539932843,8,24,15,30,32,45,225.0,5.0,1125.0,62.5,0.075
7.428397518917852,81,43,53,15,0,16,10.0,73.50857962736168,7,19,12,24,26,36,169.21582985307933,4.421052631578948,748.1120898767718,41.56178277093177,0.05640527661769311
