fitness_score,loc,lloc,sloc,comment,multi,blank,avg_cyclomatic_complexity,maintainability_index,halstead_h1,halstead_h2,halstead_N1,halstead_N2,halstead_vocabulary,halstead_length,halstead_volume,halstead_difficulty,halstead_effort,halstead_time,halstead_bugs
1.2878163217446816,46,27,24,7,6,10,6,84.24494061767678,6,9,6,12,15,18,70.32403072095333,4,281.2961228838133,15.627562382434073,0.023441344
1.6620498614958448,60,40,39,13,0,12,8,75.35432549729526,6,19,12,24,25,36,167.17882283189007,3.789473684210526,633.5197496787413,35.19554164881896,0.055726274
1.2703799455618296,43,25,25,10,0,9,0,83.94807300947052,6,10,6,12,16,18,72,3.6,259.2,14.399999999999999,0.024
1.4084507042253522,55,41,38,5,0,11,9,69.06683075,5,11,9,18,16,27,108,4.090909090909091,441.8181818181818,24.545454545454547,0.036
1.3070522118722538,55,36,33,11,2,12,5,77.44939737000648,6,23,12,24,29,36,174.88731582459263,3.130434782608696,547.4733365,30.415185360798723,0.058295772
1.477832512315271,33,22,19,1,4,10,9,80.33279442034517,5,18,9,19,23,28,126.65973476959637,2.638888888888889,334.24096675310153,18.56894259739453,0.042219911589865454
1.477832512315271,33,24,23,3,0,7,1,75.8490863,6,12,6,12,18,18,75.05865002596161,3,225.17595007788483,12.509775004326935,0.02501955
1.3921113689095128,34,26,25,0,3,6,6,74.82937011269836,4,9,6,11,13,17,62.907475208398566,2.4444444444444446,153.7738282871965,8.542990460399805,0.020969158
1.4423076923076923,53,35,32,6,4,12,4,78.62416832000538,5,12,7,14,17,21,85.83671966625714,2.9166666666666665,250.3570990265833,13.908727723699073,0.02861224
1.477832512315271,40,22,19,9,0,11,4,90.77600561046096,2,4,2,4,6,6,15.509775004326936,1,15.509775004326936,0.861654167,0.005169925
1.3761467889908259,46,29,28,5,4,11,9,81.01031747,4,10,6,12,14,18,68.53238859703687,2.4,164.4777326328885,9.137651813,0.022844129532345624
1.4492753623188408,70,43,42,10,4,15,9,74.91025993524994,5,14,13,25,19,38,161.42124551085624,4.464285714285714,720.6305603163225,40.03503112868459,0.053807082
1.5415454534289303,37,25,23,8,0,9,0,80.02690302364948,8,19,13,26,27,39,185.4406125843753,5.473684210526316,1015.0433530934226,56.39129739407903,0.061813537528125094
1.2875536480686693,41,29,29,3,0,11,7,72.30035691842896,5,10,6,12,15,18,70.32403072095333,3,210.9720922,11.720671786825555,0.023441344
1.2127302046132498,55,37,35,11,0,12,8,74.99405523355499,7,23,15,30,30,45,220.81007680238335,4.565217391304348,1008.0460027934892,56.00255571,0.073603359
1.6393442622950818,43,32,29,3,0,10,11,67.78036990680681,6,18,13,27,24,40,183.39850002884629,4.5,825.2932501298083,45.84962500721157,0.061132833342948764
1.528282171821004,43,31,28,4,4,9,11,75.86420194,6,20,15,30,26,45,211.51978731634918,4.5,951.8390429235714,52.879946829087295,0.070506596
1.4251781472684086,46,31,28,6,4,10,6,81.44385989903866,5,9,6,12,14,18,68.53238859703687,3.3333333333333335,228.44129532345625,12.691183073525346,0.022844129532345624
0.8632756409686527,40,26,23,6,3,11,6,82.93129087857506,5,12,7,14,17,21,85.83671966625714,2.9166666666666665,250.3570990265833,13.908727723699073,0.02861224
1.3752757551694124,46,30,28,11,0,11,4,83.19056462892502,4,9,5,10,13,15,55.506595772116384,2.2222222222222223,123.34799060470309,6.852666144705727,0.018502199
1.859504132231405,33,26,24,2,0,8,0,72.07186418661426,5,9,6,12,14,18,68.53238859703687,3.3333333333333335,228.44129532345625,12.691183073525346,0.022844129532345624
0.8276993394418133,45,29,26,5,4,10,6,80.73591485688416,4,14,8,16,18,24,100.07820003461549,2.2857142857142856,228.75017150769253,12.708342861538474,0.0333594
1.4778325123152707,38,29,26,0,4,8,5,78.63743056807975,3,5,3,6,8,9,27,1.8,48.6,2.7,0.009
1.2034027133326317,50,26,29,6,4,11,9,80.87625683436829,7,13,9,18,20,27,116.69205856195879,4.846153846153846,565.5076684156464,31.417092689758135,0.038897353
1.3157894736842106,57,38,37,5,4,12,8,75.59949114506075,3,12,8,16,15,24,93.76537429460444,2,187.53074858920888,10.418374921622716,0.031255125
1.9580552571493157,54,33,34,6,4,11,9,77.01856661151201,7,18,10,20,25,30,139.31568569324173,3.888888888888889,541.7832221403845,30.099067896688027,0.046438562
1.859504132231405,33,26,24,2,0,8,0,72.07186418661426,5,9,6,12,14,18,68.53238859703687,3.3333333333333335,228.44129532345625,12.691183073525346,0.022844129532345624
1.6853932584269662,53,40,38,7,0,11,0,71.10776033002935,5,17,12,24,22,36,160.5395382709427,3.5294117647058822,566.6101350739154,31.478340837439745,0.053513179
1.6620498614958448,60,40,39,13,0,12,8,75.35432549729526,6,19,12,24,25,36,167.17882283189007,3.789473684210526,633.5197496787413,35.19554164881896,0.055726274
1.6620498614958448,66,45,47,10,0,14,12,69.82242390674956,6,23,15,30,29,45,218.60914478074076,3.9130434782608696,855.4270882724638,47.52372712624799,0.072869715
1.6393442622950818,43,32,29,3,0,10,11,67.78036990680681,6,18,13,27,24,40,183.39850002884629,4.5,825.2932501298083,45.84962500721157,0.061132833342948764
1.5415454534289303,37,25,23,8,0,9,0,80.02690302364948,8,19,13,26,27,39,185.4406125843753,5.473684210526316,1015.0433530934226,56.39129739407903,0.061813537528125094
1.5318364387207417,44,30,28,9,0,11,0,76.17303606831086,10,25,18,36,35,54,276.9812829150282,7.2,1994.265236988203,110.79251316601128,0.092327094
1.528282171821004,43,31,28,4,4,9,11,75.86420194,6,20,15,30,26,45,211.51978731634918,4.5,951.8390429235714,52.879946829087295,0.070506596
1.5104433885374806,44,30,28,10,0,9,0,77.87044857,9,23,15,30,32,45,225,5.869565217391305,1320.6521739130435,73.36956521739131,0.075
1.477832512315271,33,22,19,1,4,10,9,80.33279442034517,5,18,9,19,23,28,126.65973476959637,2.638888888888889,334.24096675310153,18.56894259739453,0.042219911589865454
1.477832512315271,33,24,23,3,0,7,1,75.8490863,6,12,6,12,18,18,75.05865002596161,3,225.17595007788483,12.509775004326935,0.02501955
1.477832512315271,40,22,19,9,0,11,4,90.77600561046096,2,4,2,4,6,6,15.509775004326936,1,15.509775004326936,0.861654167,0.005169925
1.477832512315271,72,44,41,13,4,15,4,74.17129376040626,9,30,20,39,39,59,311.8387309128727,5.85,1824.256575840305,101.34758754668361,0.10394624363762422
1.477832512315271,40,25,22,6,4,11,11,80.74125407,7,24,13,27,31,40,198.16785241547504,3.9375,780.2859188859329,43.34921771588516,0.066055951
1.477832512315271,67,52,49,10,0,11,5,66.20448883,6,39,26,52,45,78,428.36454151371464,4,1713.4581660548586,95.19212033638104,0.14278818050457154
1.4778325123152707,38,29,26,0,4,8,5,78.63743056807975,3,5,3,6,8,9,27,1.8,48.6,2.7,0.009
1.4778325123152707,50,39,36,5,4,8,7,77.49960392503637,3,8,5,10,11,15,51.89147427955947,1.875,97.29651427,5.405361904120777,0.017297158
1.4729151320137326,49,31,29,12,0,12,9,79.0231602,7,18,12,25,25,37,171.8226790216648,4.861111111111111,835.2491341330928,46.40272967406071,0.057274226340554936
1.4598540145985404,47,32,29,8,4,10,5,81.50825062696303,4,11,7,14,15,21,82.04470251,2.5454545454545454,208.84106092889172,11.602281162716206,0.027348234
1.4589012121258411,62,41,37,12,0,16,5.5,71.71882824790511,10,42,27,54,52,81,461.7356171694285,6.428571428571429,2968.3003960891833,164.90557756051018,0.1539118723898095
1.4500177580970244,68,42,39,11,4,17,12,73.48465364639905,8,26,21,42,34,63,320.51015899877143,6.461538461538462,2070.9887196843692,115.05492887135385,0.10683671966625714
1.4492753623188408,70,43,42,10,4,15,9,74.91025993524994,5,14,13,25,19,38,161.42124551085624,4.464285714285714,720.6305603163225,40.03503112868459,0.053807082
1.4492753623188408,73,45,44,10,4,16,12,73.13462349,6,17,15,29,23,44,199.03672606650858,5.117647058823529,1018.599715752132,56.58887309734067,0.066345575
1.4423076923076923,53,35,32,6,4,12,4,78.62416832000538,5,12,7,14,17,21,85.83671966625714,2.9166666666666665,250.3570990265833,13.908727723699073,0.02861224
1.9580552571493157,54,33,34,6,4,11,9,77.01856661151201,7,18,10,20,25,30,139.31568569324173,3.888888888888889,541.7832221403845,30.099067896688027,0.046438562
1.859504132231405,33,26,24,2,0,8,0,72.07186418661426,5,9,6,12,14,18,68.53238859703687,3.3333333333333335,228.44129532345625,12.691183073525346,0.022844129532345624
1.8320093014428305,77,57,53,7,4,16,15,64.24210562119563,10,45,31,62,55,93,537.6664533577933,6.888888888888889,3703.924456464799,205.77358091471103,0.17922215111926446
1.6853932584269662,53,40,38,7,0,11,0,71.10776033002935,5,17,12,24,22,36,160.5395382709427,3.5294117647058822,566.6101350739154,31.478340837439745,0.053513179
1.6853932584269662,57,43,41,8,0,11,0,69.71705022669053,7,21,15,30,28,45,216.33097149259217,5,1081.6548574629608,60.091936525720044,0.072110324
1.6620498614958448,60,40,39,13,0,12,8,75.35432549729526,6,19,12,24,25,36,167.17882283189007,3.789473684210526,633.5197496787413,35.19554164881896,0.055726274
1.6620498614958448,66,45,47,10,0,14,12,69.82242390674956,6,23,15,30,29,45,218.60914478074076,3.9130434782608696,855.4270882724638,47.52372712624799,0.072869715
1.6607801086616594,67,41,42,12,4,14,14,73.01880257584267,11,34,22,44,45,66,362.4623043577585,7.117647058823529,2579.878754546399,143.32659747479994,0.12082076811925284
1.6533480297602645,71,48,50,14,0,15,12,70.40910825584851,8,29,19,38,37,57,296.93884184085016,5.241379310344827,1556.369102062387,86.46495011457705,0.098979614
1.639344262295082,77,52,54,13,0,16,14,68.05649995843997,8,30,20,40,38,60,314.8756508066151,5.333333333333333,1679.3368043019473,93.29648912788596,0.1049585502688717
1.6393442622950818,43,32,29,3,0,10,11,67.78036990680681,6,18,13,27,24,40,183.39850002884629,4.5,825.2932501298083,45.84962500721157,0.061132833342948764
1.5938424002995915,63,37,36,11,4,16,6,77.79348271024419,7,20,12,24,27,36,171.1759500778849,4.2,718.9389903271166,39.941055018173145,0.05705865
1.556333556304563,51,34,32,14,0,10,0,75.70930947818137,9,38,26,52,47,78,433.2579304308557,6.157894736842105,2667.9567294952694,148.21981830529273,0.14441931014361856
1.5415454534289303,37,25,23,8,0,9,0,80.02690302364948,8,19,13,26,27,39,185.4406125843753,5.473684210526316,1015.0433530934226,56.39129739407903,0.061813537528125094
1.5318364387207417,44,30,28,9,0,11,0,76.17303606831086,10,25,18,36,35,54,276.9812829150282,7.2,1994.265236988203,110.79251316601128,0.092327094
1.5318364387207417,75,50,48,12,0,17,1,67.29857894797259,10,45,32,63,55,95,549.2291727848427,7,3844.604209493899,213.58912274966104,0.1830763909282809
1.5318364387207417,48,33,31,9,0,12,0,74.04273308111212,10,28,20,40,38,60,314.8756508066151,7.142857142857143,2249.1117914758224,124.95065508199013,0.1049585502688717
1.528282171821004,43,31,28,4,4,9,11,75.86420194,6,20,15,30,26,45,211.51978731634918,4.5,951.8390429235714,52.879946829087295,0.070506596
1.5143176269483798,48,37,36,3,0,9,1,62.73341617499495,7,31,21,42,38,63,330.61943334694587,4.741935483870968,1567.776022645195,87.09866792473306,0.11020647778231529
1.5104433885374806,44,30,28,10,0,9,0,77.87044857,9,23,15,30,32,45,225,5.869565217391305,1320.6521739130435,73.36956521739131,0.075
1.483297942,38,26,24,6,0,9,0,78.24196987,8,16,10,20,24,30,137.5488750216347,5,687.7443751081735,38.20802083934297,0.045849625
1.480186869940386,52,32,30,14,0,13,9,78.11509737077182,9,23,16,33,32,49,245,6.456521739130435,1581.8478260869565,87.88043478260869,0.081666667
1.477832512315271,33,22,19,1,4,10,9,80.33279442034517,5,18,9,19,23,28,126.65973476959637,2.638888888888889,334.24096675310153,18.56894259739453,0.042219911589865454
1.477832512315271,33,24,23,3,0,7,1,75.8490863,6,12,6,12,18,18,75.05865002596161,3,225.17595007788483,12.509775004326935,0.02501955
1.477832512315271,40,22,19,9,0,11,4,90.77600561046096,2,4,2,4,6,6,15.509775004326936,1,15.509775004326936,0.861654167,0.005169925
1.9580552571493157,54,33,34,6,4,11,9,77.01856661151201,7,18,10,20,25,30,139.31568569324173,3.888888888888889,541.7832221403845,30.099067896688027,0.046438562
1.8691588785046729,90,57,63,16,0,18,18,66.51807094461437,10,34,23,46,44,69,376.70078168597354,6.764705882352941,2548.2699937580564,141.57055520878092,0.12556692722865784
1.859504132231405,33,26,24,2,0,8,0,72.07186418661426,5,9,6,12,14,18,68.53238859703687,3.3333333333333335,228.44129532345625,12.691183073525346,0.022844129532345624
1.859504132231405,56,37,35,18,0,9,0,77.30225709982533,9,26,15,30,35,45,230.81773576252348,5.1923076923076925,1198.476704920795,66.58203916,0.076939245
1.8320093014428305,77,57,53,7,4,16,15,64.24210562119563,10,45,31,62,55,93,537.6664533577933,6.888888888888889,3703.924456464799,205.77358091471103,0.17922215111926446
1.8320093014428305,90,66,62,12,4,18,20,62.43730474489495,10,62,47,94,72,141,869.9594252,7.580645161290323,6594.853707186807,366.38076151037814,0.2899864750677887
1.8320093014428305,81,61,57,7,4,16,16,62.77675740075577,10,45,32,64,55,96,555.0105324983674,7.111111111111111,3946.741564432835,219.2634202462686,0.18500351083278913
1.8276295307779022,55,44,43,4,0,9,1,60.34178689223334,7,40,29,58,47,87,483.2492300959545,5.075,2452.489842736969,136.2494357076094,0.1610830766986515
1.7950639522231344,61,36,37,9,4,13,10,75.47868175404994,9,27,16,32,36,48,248.15640006923098,5.333333333333333,1323.500800369232,73.52782224273511,0.0827188
1.7777290327197062,87,63,59,9,4,18,18,62.47281248985104,10,55,40,80,65,120,722.6841375634145,7.2727272727272725,5255.884636824833,291.9935909,0.24089471252113817
1.7595307917888563,71,48,47,19,0,14,11,72.83201009063883,7,26,18,36,33,54,272.3972824453565,4.846153846153846,1320.0791380044197,73.33772988913444,0.090799094
1.7595307917888563,92,60,62,21,0,20,17,65.88839541289207,9,60,44,88,69,132,806.3252282947185,6.6,5321.746506745142,295.65258370806345,0.2687750760982395
1.6853932584269662,53,40,38,7,0,11,0,71.10776033002935,5,17,12,24,22,36,160.5395382709427,3.5294117647058822,566.6101350739154,31.478340837439745,0.053513179
1.6853932584269662,57,43,41,8,0,11,0,69.71705022669053,7,21,15,30,28,45,216.33097149259217,5,1081.6548574629608,60.091936525720044,0.072110324
1.6853932584269662,58,43,41,8,0,12,0,70.47174631694023,5,18,13,26,23,39,176.41891628622352,3.611111111111111,637.0683088113627,35.392683822853485,0.058806305
1.6853932584269662,65,43,44,8,3,13,12,72.06424026299892,7,19,13,26,26,39,183.31714900750262,4.7894736842105265,877.9926610359337,48.77737005755187,0.061105716335834205
1.6853932584269662,71,48,50,11,0,15,13,69.11849708961269,6,24,16,32,30,48,235.53074858920888,4,942.1229943568355,52.34016635315753,0.07851025
1.6853932584269662,61,45,43,9,0,12,0,69.69338516,5,22,16,32,27,48,228.2346001038465,3.6363636363636362,829.9440003776236,46.10800002097909,0.0760782
1.6795697205355224,39,30,30,8,0,7,0,76.64765713,8,21,12,24,29,36,174.88731582459263,4.571428571428571,799.4848723409948,44.41582624116638,0.058295772
1.6620498614958448,60,40,39,13,0,12,8,75.35432549729526,6,19,12,24,25,36,167.17882283189007,3.789473684210526,633.5197496787413,35.19554164881896,0.055726274
1.6620498614958448,66,45,47,10,0,14,12,69.82242390674956,6,23,15,30,29,45,218.60914478074076,3.9130434782608696,855.4270882724638,47.52372712624799,0.072869715
1.6620498614958448,64,42,41,15,0,13,8,75.14196093889989,6,21,13,26,27,39,185.4406125843753,3.7142857142857144,688.7794181705368,38.26552323169649,0.061813537528125094
1.6607801086616594,67,41,42,12,4,14,14,73.01880257584267,11,34,22,44,45,66,362.4623043577585,7.117647058823529,2579.878754546399,143.32659747479994,0.12082076811925284
1.6533480297602645,71,48,50,14,0,15,12,70.40910825584851,8,29,19,38,37,57,296.93884184085016,5.241379310344827,1556.369102062387,86.46495011457705,0.098979614
1.6533480297602645,70,47,49,13,0,15,12,70.20814493903838,8,29,19,38,37,57,296.93884184085016,5.241379310344827,1556.369102062387,86.46495011457705,0.098979614
2.535285863,36,28,26,6,0,8,0,77.14380608653369,7,18,10,20,25,30,139.31568569324173,3.888888888888889,541.7832221403845,30.099067896688027,0.046438562
1.993355481727575,93,60,66,21,0,17,19,66.95481761849442,10,39,27,54,49,81,454.7914973733319,6.923076923076923,3148.556520276913,174.91980668205073,0.15159716579111063
1.9588731761349694,62,37,38,9,4,14,9,75.21418810117402,9,26,16,32,35,48,246.20558481335837,5.538461538461538,1363.6001620432155,75.75556455795642,0.082068528
1.9580552571493157,54,33,34,6,4,11,9,77.01856661151201,7,18,10,20,25,30,139.31568569324173,3.888888888888889,541.7832221403845,30.099067896688027,0.046438562
1.9579274661437096,59,41,42,5,4,10,11,71.04634637,8,23,14,28,31,42,208.0762450362488,4.869565217391305,1013.2408453939072,56.29115807743929,0.069358748
1.9505015115621382,82,61,57,9,4,17,14,64.16989443217136,8,50,34,68,58,102,597.5140615030124,5.44,3250.4764945763877,180.58202747646598,0.19917135383433746
1.8735537522995758,121,73,78,29,4,25,23,63.66326544,11,73,54,108,84,162,1035.5554224901591,8.136986301369863,8426.300287111706,468.1277937284281,0.345185141
1.8691588785046729,90,57,63,16,0,18,18,66.51807094461437,10,34,23,46,44,69,376.70078168597354,6.764705882352941,2548.2699937580564,141.57055520878092,0.12556692722865784
1.8637721542780947,93,66,64,18,4,17,21,64.51917154567802,10,61,44,88,71,132,811.7666197746181,7.213114754098361,5855.365781980852,325.2980989989362,0.270588873
1.859504132231405,33,26,24,2,0,8,0,72.07186418661426,5,9,6,12,14,18,68.53238859703687,3.3333333333333335,228.44129532345625,12.691183073525346,0.022844129532345624
1.859504132231405,56,37,35,18,0,9,0,77.30225709982533,9,26,15,30,35,45,230.81773576252348,5.1923076923076925,1198.476704920795,66.58203916,0.076939245
1.859504132231405,75,51,52,10,3,14,16,68.41029401240428,10,24,20,39,34,59,300.16030763377006,8.125,2438.802499524382,135.48902775135454,0.10005343587792336
1.859504132231405,72,47,48,9,3,15,13,70.61689410342548,7,20,15,30,27,45,213.9699375973561,5.25,1123.3421723861195,62.40789846589553,0.071323313
1.8443045612947664,91,59,58,18,4,18,17,69.08399242211524,9,32,23,46,41,69,369.6710883186478,6.46875,2391.3098525612527,132.85054736451403,0.12322369610621592
1.8404907975460123,64,50,50,14,0,11,0,68.92891789978692,10,41,25,50,51,75,425.4319006478622,6.097560975609756,2594.0969551698918,144.11649750943843,0.1418106335492874
1.8320093014428305,77,57,53,7,4,16,15,64.24210562119563,10,45,31,62,55,93,537.6664533577933,6.888888888888889,3703.924456464799,205.77358091471103,0.17922215111926446
1.8320093014428305,90,66,62,12,4,18,20,62.43730474489495,10,62,47,94,72,141,869.9594252,7.580645161290323,6594.853707186807,366.38076151037814,0.2899864750677887
1.8320093014428305,81,61,57,7,4,16,16,62.77675740075577,10,45,32,64,55,96,555.0105324983674,7.111111111111111,3946.741564432835,219.2634202462686,0.18500351083278913
1.8320093014428305,90,68,64,10,4,17,21,60.48822698337704,11,66,50,100,77,150,940.0179811042353,8.333333333333334,7833.483175868629,435.19350977047935,0.3133393270347451
1.8320093014428305,84,61,57,8,4,18,18,62.88944766163134,10,49,35,70,59,105,617.6775201829934,7.142857142857143,4411.982287021381,245.1101270567434,0.20589250672766446
1.8320093014428305,111,82,78,18,4,21,29,58.90927649156408,10,77,61,122,87,183,1179.0586597403174,7.922077922077922,9340.594577163552,518.9219209535307,0.39301955324677246
1.8320093014428305,83,63,59,10,4,16,17,62.79407920076318,9,60,45,90,69,135,824.6508017,6.75,5566.392911239108,309.2440506243949,0.27488360055501765
1.8320093014428305,102,74,70,19,4,20,25,61.70602979001333,11,73,57,114,84,171,1093.086279295168,8.589041096,9388.562974,521.5868319011189,0.36436209309838935
1.8276295307779022,55,44,43,4,0,9,1,60.34178689223334,7,40,29,58,47,87,483.2492300959545,5.075,2452.489842736969,136.2494357076094,0.1610830766986515
1.8276295307779022,57,46,45,5,0,9,1,60.64313583,7,44,32,64,51,96,544.5528328292636,5.090909090909091,2772.268967130796,154.01494261837757,0.18151761094308785
2.535285863,36,28,26,6,0,8,0,77.14380608653369,7,18,10,20,25,30,139.31568569324173,3.888888888888889,541.7832221403845,30.099067896688027,0.046438562
2.2140221402214024,106,67,73,22,0,20,20,64.60323365234133,12,51,33,66,63,99,591.7507124264918,7.764705882352941,4594.770237664524,255.26501320358466,0.19725023747549725
2.2140221402214024,98,62,68,23,0,19,20,66.79621673,10,39,28,56,49,84,471.6356269056775,7.179487179,3386.1019367587105,188.1167742643728,0.15721187563522585
1.993355481727575,93,60,66,21,0,17,19,66.95481761849442,10,39,27,54,49,81,454.7914973733319,6.923076923076923,3148.556520276913,174.91980668205073,0.15159716579111063
1.993355481727575,94,61,67,24,0,17,20,66.68456211,11,46,33,66,57,99,577.4561114023095,7.891304347826087,4556.881923,253.16010681043275,0.1924853704674365
1.9588731761349694,62,37,38,9,4,14,9,75.21418810117402,9,26,16,32,35,48,246.20558481335837,5.538461538461538,1363.6001620432155,75.75556455795642,0.082068528
1.9587190888830406,125,92,90,23,4,24,23,58.88930460634986,10,88,63,126,98,189,1250.1801605377746,7.159090909090909,8950.153422031795,497.2307456684331,0.41672672017925816
1.9580552571493157,54,33,34,6,4,11,9,77.01856661151201,7,18,10,20,25,30,139.31568569324173,3.888888888888889,541.7832221403845,30.099067896688027,0.046438562
1.9579274661437096,59,41,42,5,4,10,11,71.04634637,8,23,14,28,31,42,208.0762450362488,4.869565217391305,1013.2408453939072,56.29115807743929,0.069358748
1.9505015115621382,82,61,57,9,4,17,14,64.16989443217136,8,50,34,68,58,102,597.5140615030124,5.44,3250.4764945763877,180.58202747646598,0.19917135383433746
1.9505015115621382,85,65,61,9,4,16,15,62.80262380098311,8,50,35,70,58,105,615.0880044883951,5.6,3444.4928251350125,191.3607125075007,0.20502933482946503
1.9390426030885266,128,88,88,21,4,24,34,57.04339147171291,14,85,72,143,99,215,1425.311673317116,11.776470588235295,16785.140999887448,932.5078333270804,0.47510389110570533
1.8897087000341646,91,65,61,13,4,18,19,64.04672649468166,10,52,38,76,62,114,678.7783793841038,7.3076923076923075,4960.3035416530665,275.5724189807259,0.22625945979470127
1.8743369880542902,87,63,59,13,4,18,14,64.85508124131455,9,62,42,84,71,126,774.8681370575899,6.096774193548387,4724.196061415629,262.4553367453127,0.25828937901919663
1.8735537522995758,121,73,78,29,4,25,23,63.66326544,11,73,54,108,84,162,1035.5554224901591,8.136986301369863,8426.300287111706,468.1277937284281,0.345185141
1.8735537522995758,124,75,80,30,4,25,25,62.91656166359128,11,76,58,116,87,174,1121.0721682776789,8.394736842105264,9411.105833699463,522.8392129833035,0.37369072275922627
1.8691588785046729,90,57,63,16,0,18,18,66.51807094461437,10,34,23,46,44,69,376.70078168597354,6.764705882352941,2548.2699937580564,141.57055520878092,0.12556692722865784
1.8637721542780947,93,66,64,18,4,17,21,64.51917154567802,10,61,44,88,71,132,811.7666197746181,7.213114754098361,5855.365781980852,325.2980989989362,0.270588873
1.859504132231405,33,26,24,2,0,8,0,72.07186418661426,5,9,6,12,14,18,68.53238859703687,3.3333333333333335,228.44129532345625,12.691183073525346,0.022844129532345624
1.859504132231405,56,37,35,18,0,9,0,77.30225709982533,9,26,15,30,35,45,230.81773576252348,5.1923076923076925,1198.476704920795,66.58203916,0.076939245
1.859504132231405,75,51,52,10,3,14,16,68.41029401240428,10,24,20,39,34,59,300.16030763377006,8.125,2438.802499524382,135.48902775135454,0.10005343587792336
1.859504132231405,72,47,48,9,3,15,13,70.61689410342548,7,20,15,30,27,45,213.9699375973561,5.25,1123.3421723861195,62.40789846589553,0.071323313
1.859504132231405,109,78,78,14,3,20,26,57.88867294419801,12,72,60,119,84,179,1144.224818677398,9.916666666666666,11346.896118550862,630.3831176972701,0.381408273
1.859504132231405,37,29,27,5,0,8,0,75.24657726,7,16,10,20,23,30,135.7068586817104,4.375,593.7175067,32.98430592958239,0.04523562
1.8569345980241534,90,62,63,12,4,16,19,65.11916998,11,34,27,53,45,80,439.34824770637397,8.573529411764707,3766.765123717883,209.26472909543793,0.14644941590212465
2.912621359223301,69,43,44,14,5,13,10,73.86444724577233,10,34,21,42,44,63,343.9441919741497,6.176470588235294,2124.3611857226892,118.02006587348274,0.11464806399138323
2.535285863,36,28,26,6,0,8,0,77.14380608653369,7,18,10,20,25,30,139.31568569324173,3.888888888888889,541.7832221403845,30.099067896688027,0.046438562
2.3904382470119523,90,61,62,22,5,16,22,67.39658407208023,11,46,33,66,57,99,577.4561114023095,7.891304347826087,4556.881923,253.16010681043275,0.1924853704674365
2.377421598844857,142,102,102,25,4,24,37,55.37464507655709,13,80,70,139,93,209,1366.6841915215787,11.29375,15434.989587996828,857.4994215553793,0.4555613971738596
2.2140221402214024,106,67,73,22,0,20,20,64.60323365234133,12,51,33,66,63,99,591.7507124264918,7.764705882352941,4594.770237664524,255.26501320358466,0.19725023747549725
2.2140221402214024,98,62,68,23,0,19,20,66.79621673,10,39,28,56,49,84,471.6356269056775,7.179487179,3386.1019367587105,188.1167742643728,0.15721187563522585
2.2140221402214024,104,66,72,25,0,20,21,65.51286665,11,47,34,68,58,102,597.5140615030124,7.957446808510638,4754.686361747375,264.1492423192986,0.19917135383433746
2.210380394428171,146,100,101,31,4,24,33,58.123280778866516,13,72,57,113,85,170,1089.5964591434094,10.20138888888889,11115.397211678253,617.5220673154586,0.3631988197144698
2.210380394428171,109,71,76,23,4,19,22,64.82469269729461,11,47,34,68,58,102,597.5140615030124,7.957446808510638,4754.686361747375,264.1492423192986,0.19917135383433746
2.187546684615174,107,75,75,15,3,21,22,60.41791433967142,12,60,47,93,72,140,863.7895002019237,9.3,8033.242351877891,446.29124177099396,0.2879298334006412
2.0977975666566495,134,89,94,26,0,27,27,58.10314616046579,12,90,62,124,102,186,1241.0711136066982,8.266666666666667,10259.521205815372,569.9734003230762,0.41369037120223273
2.027027027027027,102,63,69,25,0,21,21,66.77384902650668,11,41,29,58,52,87,495.93825547827504,7.780487804878049,3858.641548721213,214.36897492895628,0.16531275182609168
1.993355481727575,93,60,66,21,0,17,19,66.95481761849442,10,39,27,54,49,81,454.7914973733319,6.923076923076923,3148.556520276913,174.91980668205073,0.15159716579111063
1.993355481727575,94,61,67,24,0,17,20,66.68456211,11,46,33,66,57,99,577.4561114023095,7.891304347826087,4556.881923,253.16010681043275,0.1924853704674365
1.993355481727575,94,61,67,24,0,17,20,66.68456211,11,46,33,66,57,99,577.4561114023095,7.891304347826087,4556.881923,253.16010681043275,0.1924853704674365
1.993355481727575,109,72,76,26,0,19,23,63.79386019,11,57,39,78,68,117,712.2331524262897,7.526315789473684,5360.4916208926015,297.80509004958896,0.23741105080876324
1.9827291465400099,83,62,58,12,4,17,14,64.97824546264388,9,56,39,78,65,117,704.6170341243292,6.267857142857143,4416.438910314992,245.3577172397218,0.23487234470810972
1.9607843137254901,132,92,90,27,4,29,21,60.044750438921014,10,85,64,128,95,192,1261.412276799542,7.529411764705882,9497.692437078904,527.6495798377168,0.4204707589331807
1.9600672042426852,58,35,36,7,5,11,10,75.39504283601934,9,28,16,32,37,48,250.05376155018962,5.142857142857143,1285.9907736866896,71.44393187148276,0.083351254
1.9588731761349694,62,37,38,9,4,14,9,75.21418810117402,9,26,16,32,35,48,246.20558481335837,5.538461538461538,1363.6001620432155,75.75556455795642,0.082068528
1.9587836459309922,62,43,44,8,4,11,11,71.15040615474446,10,31,20,40,41,60,321.4531203,6.451612903225806,2073.8910985618386,115.21617214232437,0.10715104009236168
1.9587190888830406,125,92,90,23,4,24,23,58.88930460634986,10,88,63,126,98,189,1250.1801605377746,7.159090909090909,8950.153422031795,497.2307456684331,0.41672672017925816
1.9580552571493157,54,33,34,6,4,11,9,77.01856661151201,7,18,10,20,25,30,139.31568569324173,3.888888888888889,541.7832221403845,30.099067896688027,0.046438562
1.9579274661437096,59,41,42,5,4,10,11,71.04634637,8,23,14,28,31,42,208.0762450362488,4.869565217391305,1013.2408453939072,56.29115807743929,0.069358748
1.9505015115621382,82,61,57,9,4,17,14,64.16989443217136,8,50,34,68,58,102,597.5140615030124,5.44,3250.4764945763877,180.58202747646598,0.19917135383433746
2.912621359223301,69,43,44,14,5,13,10,73.86444724577233,10,34,21,42,44,63,343.9441919741497,6.176470588235294,2124.3611857226892,118.02006587348274,0.11464806399138323
2.7149321266968327,133,73,100,28,0,20,22,62.962093145059576,10,45,33,66,55,99,572.3546116389414,7.333333333333333,4197.267152018903,233.18150844549461,0.1907848705463138
2.5923918723883075,143,99,100,21,4,26,32,56.03801564727632,13,74,57,113,87,170,1095.300394294284,9.925675675675675,10871.59648120475,603.9775822891528,0.365100131
2.535285863,36,28,26,6,0,8,0,77.14380608653369,7,18,10,20,25,30,139.31568569324173,3.888888888888889,541.7832221403845,30.099067896688027,0.046438562
2.4092426291977036,158,110,113,29,4,27,42,53.56793950125723,13,88,84,167,101,251,1671.2110821707006,12.335227272727273,20614.768519276087,1145.2649177375604,0.5570703607235669
2.3904382470119523,90,61,62,22,5,16,22,67.39658407208023,11,46,33,66,57,99,577.4561114023095,7.891304347826087,4556.881923,253.16010681043275,0.1924853704674365
2.3904382470119523,104,66,72,28,0,20,23,65.88703488850494,11,47,34,68,58,102,597.5140615030124,7.957446808510638,4754.686361747375,264.1492423192986,0.19917135383433746
2.387465394920704,120,78,79,34,5,23,26,63.39758853163129,11,66,51,102,77,153,958.8183407,8.5,8149.955896,452.7753275652067,0.319606114
2.3861935778188794,158,106,107,35,4,26,38,56.77521328674407,13,79,64,128,92,192,1252.5238955629466,10.531645569620252,13191.137735549006,732.8409853,0.4175079651876489
2.377421598844857,142,102,102,25,4,24,37,55.37464507655709,13,80,70,139,93,209,1366.6841915215787,11.29375,15434.989587996828,857.4994215553793,0.4555613971738596
2.377421598844857,139,102,102,24,4,22,37,55.11740455925621,13,80,70,139,93,209,1366.6841915215787,11.29375,15434.989587996828,857.4994215553793,0.4555613971738596
2.377421598844857,141,102,102,24,5,23,37,55.37464507655709,13,80,70,139,93,209,1366.6841915215787,11.29375,15434.989587996828,857.4994215553793,0.4555613971738596
2.2988505747126435,116,77,78,35,5,21,25,63.796952583240916,11,66,50,100,77,150,940.0179811042353,8.333333333333334,7833.483175868629,435.19350977047935,0.3133393270347451
2.286655081,103,71,72,23,5,18,29,63.34916224707098,13,62,45,90,75,135,840.8905232169438,9.435483870967742,7934.208969063099,440.7893871701722,0.2802968410723146
2.2140221402214024,106,67,73,22,0,20,20,64.60323365234133,12,51,33,66,63,99,591.7507124264918,7.764705882352941,4594.770237664524,255.26501320358466,0.19725023747549725
2.2140221402214024,98,62,68,23,0,19,20,66.79621673,10,39,28,56,49,84,471.6356269056775,7.179487179,3386.1019367587105,188.1167742643728,0.15721187563522585
2.2140221402214024,104,66,72,25,0,20,21,65.51286665,11,47,34,68,58,102,597.5140615030124,7.957446808510638,4754.686361747375,264.1492423192986,0.19917135383433746
2.2140221402214024,106,68,74,26,0,20,22,65.05392983158734,11,49,35,70,60,105,620.2235125388945,7.857142857142857,4873.184741377028,270.73248563205715,0.20674117084629817
2.2140221402214024,104,66,72,25,0,20,21,65.51286665,11,47,34,68,58,102,597.5140615030124,7.957446808510638,4754.686361747375,264.1492423192986,0.19917135383433746
2.2140221402214024,99,63,69,25,0,19,21,66.33806069820075,10,45,33,66,55,99,572.3546116389414,7.333333333333333,4197.267152018903,233.18150844549461,0.1907848705463138
2.2140221402214024,103,65,71,25,0,20,22,66.07137254,11,41,30,60,52,90,513.0395746326983,8.048780487804878,4129.342917775377,229.40793987640984,0.17101319154423278
2.2131078812645484,115,74,75,29,5,21,25,64.03124050524262,11,65,47,94,76,141,880.9577793955457,7.953846153846154,7007.002645,389.27792474145053,0.29365259313184855
2.210380394428171,146,100,101,31,4,24,33,58.123280778866516,13,72,57,113,85,170,1089.5964591434094,10.20138888888889,11115.397211678253,617.5220673154586,0.3631988197144698
2.210380394428171,109,71,76,23,4,19,22,64.82469269729461,11,47,34,68,58,102,597.5140615030124,7.957446808510638,4754.686361747375,264.1492423192986,0.19917135383433746
2.210380394428171,149,101,102,32,4,25,33,58.14012826019418,13,72,57,113,85,170,1089.5964591434094,10.20138888888889,11115.397211678253,617.5220673154586,0.3631988197144698
2.978458445737061,100,70,71,17,5,17,22,63.344873989548695,11,62,41,82,73,123,761.3484207422422,7.274193548387097,5538.195770237923,307.67754279099574,0.2537828069140807
2.912621359223301,69,43,44,14,5,13,10,73.86444724577233,10,34,21,42,44,63,343.9441919741497,6.176470588235294,2124.3611857226892,118.02006587348274,0.11464806399138323
2.9117732699213823,73,45,46,17,5,14,10,73.48168357587923,10,36,23,46,46,69,381.1257749679339,6.388888888888889,2434.9702289618003,135.27612383121112,0.1270419249893113
2.764790412680712,123,78,84,32,0,25,24,62.89906026560509,11,63,47,94,74,141,875.5329246,8.206349206349206,7184.928920543708,399.16271780798377,0.2918443081845607
2.727184005254528,136,75,102,30,0,20,22,62.579099935336636,11,48,38,76,59,114,670.6213076,8.708333333333334,5839.993887253969,324.4441048474427,0.22354043587574998
2.7149321266968327,133,73,100,28,0,20,22,62.962093145059576,10,45,33,66,55,99,572.3546116389414,7.333333333333333,4197.267152018903,233.18150844549461,0.1907848705463138
2.7149321266968327,113,72,78,28,0,22,24,63.68630803884953,11,54,43,86,65,129,776.8854478806707,8.759259259,6804.941052732542,378.0522807073634,0.25896181596022355
2.5923918723883075,143,99,100,21,4,26,32,56.03801564727632,13,74,57,113,87,170,1095.300394294284,9.925675675675675,10871.59648120475,603.9775822891528,0.365100131
2.5862068965517238,76,47,48,18,5,14,11,72.51804167018372,10,39,26,52,49,78,437.94736784098626,6.666666666666667,2919.6491189399085,162.20272882999492,0.1459824559469954
2.535285863,36,28,26,6,0,8,0,77.14380608653369,7,18,10,20,25,30,139.31568569324173,3.888888888888889,541.7832221403845,30.099067896688027,0.046438562
2.488984045675824,172,125,125,31,5,28,51,50.51705599705892,14,108,96,191,122,287,1989.1216158805485,12.37962962962963,24624.588892891607,1368.0327162717558,0.6630405386268495
2.464065708418891,106,75,76,22,5,18,24,63.11473758926473,11,59,44,88,70,132,809.0653582367356,8.203389830508474,6637.0785319759325,368.7265851,0.26968845274557857
2.4390243902439024,108,72,77,25,4,18,23,64.57316868404236,12,51,37,74,63,111,663.4780715084908,8.705882352941176,5776.162034309214,320.8978907949563,0.22115935716949692
2.4390243902439024,108,69,75,27,0,21,23,64.74434476,11,50,37,74,61,111,658.3118444694804,8.14,5358.658413981571,297.7032452211984,0.2194372814898268
2.4092426291977036,158,110,113,29,4,27,42,53.56793950125723,13,88,84,167,101,251,1671.2110821707006,12.335227272727273,20614.768519276087,1145.2649177375604,0.5570703607235669
2.3904382470119523,90,61,62,22,5,16,22,67.39658407208023,11,46,33,66,57,99,577.4561114023095,7.891304347826087,4556.881923,253.16010681043275,0.1924853704674365
2.3904382470119523,104,66,72,28,0,20,23,65.88703488850494,11,47,34,68,58,102,597.5140615030124,7.957446808510638,4754.686361747375,264.1492423192986,0.19917135383433746
2.3904382470119523,104,66,72,28,0,20,23,65.88703488850494,11,47,34,68,58,102,597.5140615030124,7.957446808510638,4754.686361747375,264.1492423192986,0.19917135383433746
2.3904382470119523,93,63,64,23,5,17,24,66.55005587241328,11,48,36,72,59,108,635.3254493310789,8.25,5241.434957,291.19083094341113,0.21177514977702627
2.3904382470119523,90,61,62,22,5,16,22,67.39658407208023,11,46,33,66,57,99,577.4561114023095,7.891304347826087,4556.881923,253.16010681043275,0.1924853704674365
2.3904382470119523,120,78,84,28,0,22,25,62.33634917028396,12,60,42,84,72,126,777.4105501817313,8.4,6530.2486215265435,362.7915901,0.25913685006057713
2.3904382470119523,90,61,62,23,5,16,22,67.34377918261937,11,47,35,70,58,105,615.0880044883951,8.191489361702128,5038.486845,279.9159358487378,0.20502933482946503
2.387465394920704,120,78,79,34,5,23,26,63.39758853163129,11,66,51,102,77,153,958.8183407,8.5,8149.955896,452.7753275652067,0.319606114
2.387465394920704,120,78,79,34,5,23,26,63.13272622143375,11,70,55,110,81,165,1046.0752504759632,8.642857142857142,9041.078950542253,502.2821639,0.3486917501586544
2.3861935778188794,158,106,107,35,4,26,38,56.77521328674407,13,79,64,128,92,192,1252.5238955629466,10.531645569620252,13191.137735549006,732.8409853,0.4175079651876489
3.9473684210526323,131,85,86,40,4,24,27,61.89809256988899,11,76,61,122,87,183,1179.0586597403174,8.828947368421053,10409.846851128328,578.3248250626849,0.39301955324677246
3.5087719298245617,121,79,82,30,5,25,24,62.81851243672526,11,73,54,108,84,162,1035.5554224901591,8.136986301369863,8426.300287111706,468.1277937284281,0.345185141
3.1362292833818053,140,96,97,44,5,24,33,60.221536292954426,11,64,57,114,75,171,1065.1279960747956,9.796875,10434.925836545264,579.7181020302925,0.35504266535826523
3.1362292833818053,143,99,100,40,5,24,37,58.11433101907271,11,82,74,148,93,222,1451.6932560659832,9.926829268292684,14410.711102898907,800.5950612721615,0.48389775202199437
2.978458445737061,100,70,71,17,5,17,22,63.344873989548695,11,62,41,82,73,123,761.3484207422422,7.274193548387097,5538.195770237923,307.67754279099574,0.2537828069140807
2.912621359223301,69,43,44,14,5,13,10,73.86444724577233,10,34,21,42,44,63,343.9441919741497,6.176470588235294,2124.3611857226892,118.02006587348274,0.11464806399138323
2.912621359223301,72,46,47,16,5,13,11,72.12751979629137,10,41,29,58,51,87,493.50100475152016,7.073170731707317,3490.616862876606,193.9231590487003,0.1645003349171734
2.9117732699213823,73,45,46,17,5,14,10,73.48168357587923,10,36,23,46,46,69,381.1257749679339,6.388888888888889,2434.9702289618003,135.27612383121112,0.1270419249893113
2.857142857142857,80,48,49,20,5,16,11,72.07735967601462,10,43,29,58,53,87,498.32907954699834,6.744186046511628,3360.8240248518496,186.71244582510275,0.1661096931823328
2.764790412680712,123,78,84,32,0,25,24,62.89906026560509,11,63,47,94,74,141,875.5329246,8.206349206349206,7184.928920543708,399.16271780798377,0.2918443081845607
2.727184005254528,136,75,102,30,0,20,22,62.579099935336636,11,48,38,76,59,114,670.6213076,8.708333333333334,5839.993887253969,324.4441048474427,0.22354043587574998
2.727184005254528,108,69,75,29,0,20,23,65.00599269358528,11,48,39,78,59,117,688.2692367753355,8.9375,6151.406303679561,341.74479464886446,0.22942307892511182
2.727184005254528,139,76,103,31,0,21,22,62.263042018625555,11,52,42,84,63,126,753.1372703609895,8.884615384615385,6691.334978976484,371.74083216536025,0.25104575678699653
2.7149321266968327,133,73,100,28,0,20,22,62.962093145059576,10,45,33,66,55,99,572.3546116389414,7.333333333333333,4197.267152018903,233.18150844549461,0.1907848705463138
2.7149321266968327,113,72,78,28,0,22,24,63.68630803884953,11,54,43,86,65,129,776.8854478806707,8.759259259,6804.941052732542,378.0522807073634,0.25896181596022355
2.7149321266968327,113,72,78,28,0,22,24,63.68630803884953,11,54,43,86,65,129,776.8854478806707,8.759259259,6804.941052732542,378.0522807073634,0.25896181596022355
2.7149321266968327,128,84,89,32,4,23,28,61.571886649448594,12,65,53,106,77,159,996.4190599704895,9.784615384615385,9749.577263711251,541.6431813172917,0.3321396866568298
2.7149321266968327,125,83,88,32,4,22,25,62.55542300386042,12,60,47,94,72,141,869.9594252,9.4,8177.618597,454.3121442728689,0.2899864750677887
2.6785714285714284,77,47,48,18,5,15,12,72.23767359957401,10,41,27,54,51,81,459.46645269969116,6.585365853658536,3025.754688510161,168.09748269500895,0.1531554842332304
2.5974025974025974,134,90,91,21,4,26,30,58.339241134738444,13,65,51,101,78,152,955.3811372670618,10.1,9649.349486397325,536.0749715,0.3184603790890206
2.5945942075860886,131,87,88,43,5,24,26,62.22968921371066,11,68,56,112,79,168,1059.0351656937532,9.058823529411764,9593.612677461058,532.9784820811699,0.35301172189791774
2.5923918723883075,143,99,100,21,4,26,32,56.03801564727632,13,74,57,113,87,170,1095.300394294284,9.925675675675675,10871.59648120475,603.9775822891528,0.365100131
2.5862068965517238,76,47,48,18,5,14,11,72.51804167018372,10,39,26,52,49,78,437.94736784098626,6.666666666666667,2919.6491189399085,162.20272882999492,0.1459824559469954
2.5862068965517238,76,47,48,18,5,14,11,72.38753088503051,10,40,27,54,50,81,457.1523513717527,6.75,3085.7783717593306,171.43213176440725,0.15238411712391756
2.535285863,36,28,26,6,0,8,0,77.14380608653369,7,18,10,20,25,30,139.31568569324173,3.888888888888889,541.7832221403845,30.099067896688027,0.046438562
3.947368421,131,85,86,40,4,24,27,61.89809257,11,76,61,122,87,183,1179.05866,8.828947368,10409.84685,578.3248251,0.393019553
3.50877193,121,79,82,30,5,25,24,62.81851244,11,73,54,108,84,162,1035.555422,8.136986301,8426.300287,468.1277937,0.34518514
3.136229283,140,96,97,44,5,24,33,60.22153629,11,64,57,114,75,171,1065.127996,9.796875,10434.92584,579.718102,0.355042665
3.136229283,143,99,100,40,5,24,37,58.11433102,11,82,74,148,93,222,1451.693256,9.926829268,14410.7111,800.5950613,0.483897752
2.978458446,100,70,71,17,5,17,22,63.34487399,11,62,41,82,73,123,761.3484207,7.274193548,5538.19577,307.6775428,0.253782807
2.912621359,69,43,44,14,5,13,10,73.86444725,10,34,21,42,44,63,343.944192,6.176470588,2124.361186,118.0200659,0.114648064
2.912621359,72,46,47,16,5,13,11,72.1275198,10,41,29,58,51,87,493.5010048,7.073170732,3490.616863,193.923159,0.164500335
2.91177327,73,45,46,17,5,14,10,73.48168358,10,36,23,46,46,69,381.125775,6.388888889,2434.970229,135.2761238,0.127041925
2.857142857,80,48,49,20,5,16,11,72.07735968,10,43,29,58,53,87,498.3290795,6.744186047,3360.824025,186.7124458,0.166109693
2.764790413,123,78,84,32,0,25,24,62.89906027,11,63,47,94,74,141,875.532925,8.206349206,7184.928921,399.1627178,0.291844308
2.727184005,136,75,102,30,0,20,22,62.57909994,11,48,38,76,59,114,670.621308,8.708333333,5839.993887,324.4441048,0.223540436
2.727184005,108,69,75,29,0,20,23,65.00599269,11,48,39,78,59,117,688.2692368,8.9375,6151.406304,341.7447946,0.229423079
2.727184005,139,76,103,31,0,21,22,62.26304202,11,52,42,84,63,126,753.1372704,8.884615385,6691.334979,371.7408322,0.251045757
2.714932127,133,73,100,28,0,20,22,62.96209315,10,45,33,66,55,99,572.3546116,7.333333333,4197.267152,233.1815084,0.190784871
2.714932127,113,72,78,28,0,22,24,63.68630804,11,54,43,86,65,129,776.8854479,8.75925926,6804.941053,378.0522807,0.258961816
2.714932127,113,72,78,28,0,22,24,63.68630804,11,54,43,86,65,129,776.8854479,8.75925926,6804.941053,378.0522807,0.258961816
2.714932127,128,84,89,32,4,23,28,61.57188665,12,65,53,106,77,159,996.41906,9.784615385,9749.577264,541.6431813,0.332139687
1.617250674,125,83,88,32,4,22,25,62.555423,12,60,47,94,72,141,869.959425,9.4,8177.6186,454.3121443,0.289986475
2.678571429,77,47,48,18,5,15,12,72.2376736,10,41,27,54,51,81,459.4664527,6.585365854,3025.754689,168.0974827,0.153155484
2.597402597,134,90,91,21,4,26,30,58.33924113,13,65,51,101,78,152,955.3811373,10.1,9649.349486,536.074971,0.318460379
2.594594208,131,87,88,43,5,24,26,62.22968921,11,68,56,112,79,168,1059.035166,9.058823529,9593.612677,532.9784821,0.353011722
2.592391872,143,99,100,21,4,26,32,56.03801565,13,74,57,113,87,170,1095.300394,9.925675676,10871.59648,603.9775823,0.36510013
2.586206897,76,47,48,18,5,14,11,72.51804167,10,39,26,52,49,78,437.9473678,6.666666667,2919.649119,162.2027288,0.145982456
2.586206897,76,47,48,18,5,14,11,72.38753089,10,40,27,54,50,81,457.1523514,6.75,3085.778372,171.4321318,0.152384117
1.374067713,36,28,26,6,0,8,0,77.14380609,7,18,10,20,25,30,139.3156857,3.888888889,541.7832221,30.0990679,0.04643856
3.947368421,131,85,86,40,4,24,27,61.89809257,11,76,61,122,87,183,1179.05866,8.828947368,10409.84685,578.3248251,0.393019553
3.947368421,133,88,89,42,4,23,28,61.29994564,11,77,64,128,88,192,1240.210871,9.142857143,11339.07082,629.9483788,0.413403624
3.50877193,121,79,82,30,5,25,24,62.81851244,11,73,54,108,84,162,1035.555422,8.136986301,8426.300287,468.1277937,0.34518514
3.50877193,122,79,82,31,5,25,24,62.93416349,11,73,54,108,84,162,1035.555422,8.136986301,8426.300287,468.1277937,0.34518514
3.508762696,127,81,84,33,5,28,24,62.62187698,11,76,57,114,87,171,1101.743338,8.25,9089.382537,504.9656965,0.367247779
3.409090909,131,86,89,32,5,27,24,61.50474052,12,77,61,121,89,182,1178.583484,9.428571429,11112.35857,617.353254,0.392861161
3.191489362,148,93,99,40,0,35,30,59.13397821,12,89,74,148,101,222,1478.122949,9.97752809,14748.01325,819.3340692,0.49270765
3.136229283,140,96,97,44,5,24,33,60.22153629,11,64,57,114,75,171,1065.127996,9.796875,10434.92584,579.718102,0.355042665
3.136229283,143,99,100,40,5,24,37,58.11433102,11,82,74,148,93,222,1451.693256,9.926829268,14410.7111,800.5950613,0.483897752
3.136229283,157,108,109,24,5,32,37,53.93755135,11,91,78,156,102,234,1561.34753,9.428571429,14721.27671,817.848706,0.520449177
3.136229283,144,97,98,43,6,26,33,59.91748823,11,67,60,120,78,180,1131.372399,9.850746269,11144.86244,619.1590245,0.377124133
2.979449003,119,80,81,31,4,24,26,62.29340378,11,76,57,114,87,171,1101.743338,8.25,9089.382537,504.9656965,0.367247779
2.978458446,100,70,71,17,5,17,22,63.34487399,11,62,41,82,73,123,761.3484207,7.274193548,5538.19577,307.6775428,0.253782807
2.912621359,69,43,44,14,5,13,10,73.86444725,10,34,21,42,44,63,343.944192,6.176470588,2124.361186,118.0200659,0.114648064
2.912621359,72,46,47,16,5,13,11,72.1275198,10,41,29,58,51,87,493.5010048,7.073170732,3490.616863,193.923159,0.164500335
2.912621359,74,46,47,18,5,13,11,72.4156558,10,41,29,58,51,87,493.5010048,7.073170732,3490.616863,193.923159,0.164500335
2.912621359,74,46,47,16,5,15,11,72.1275198,10,41,29,58,51,87,493.5010048,7.073170732,3490.616863,193.923159,0.164500335
2.912621359,4,4,4,2,0,0,0,100,2,8,4,8,10,12,39.86313714,1,39.86313714,2.21461873,0.013287712
2.91177327,73,45,46,17,5,14,10,73.48168358,10,36,23,46,46,69,381.125775,6.388888889,2434.970229,135.2761238,0.127041925
2.857142857,80,48,49,20,5,16,11,72.07735968,10,43,29,58,53,87,498.3290795,6.744186047,3360.824025,186.7124458,0.166109693
2.814178142,141,84,89,35,5,34,25,61.57995926,12,88,66,132,100,198,1315.483526,9,11839.35173,657.7417628,0.438494509
2.764796783,126,80,86,34,0,26,24,62.576277,11,66,51,102,77,153,958.818341,8.5,8149.9559,452.7753276,0.31960611
2.764790413,123,78,84,32,0,25,24,62.89906027,11,63,47,94,74,141,875.532925,8.206349206,7184.928921,399.1627178,0.291844308
2.761000315,150,101,102,46,5,28,37,58.14320831,11,84,76,152,95,228,1497.927079,9.952380952,14907.94093,828.2189403,0.499309026
2.732133176,129,78,83,32,5,30,25,63.73783648,11,52,45,90,63,135,806.9327897,9.51923077,7681.37944,426.7433022,0.268977597
4.761904762,105,68,74,30,0,22,20,65.8972721,11,52,37,74,63,111,663.4780715,7.826923077,5192.991829,288.4995461,0.221159357
4.410576539,115,69,74,28,4,27,20,65.76524689,12,55,40,80,67,120,727.9307029,8.727272727,6352.84977,352.9360984,0.242643568
3.947368421,131,85,86,40,4,24,27,61.89809257,11,76,61,122,87,183,1179.05866,8.828947368,10409.84685,578.3248251,0.393019553
3.947368421,133,88,89,42,4,23,28,61.29994564,11,77,64,128,88,192,1240.210871,9.142857143,11339.07082,629.9483788,0.413403624
3.947368421,133,88,89,45,4,23,28,61.37988579,11,77,64,128,88,192,1240.210871,9.142857143,11339.07082,629.9483788,0.413403624
3.947368421,130,85,86,40,4,23,27,61.79221725,11,77,63,126,88,189,1220.832576,9,10987.49318,610.416288,0.406944192
3.947368421,131,88,89,40,4,23,28,61.15960311,11,77,65,130,88,195,1259.589166,9.285714286,11696.18511,649.7880616,0.419863055
3.947368421,131,85,86,40,4,24,27,61.89809257,11,76,61,122,87,183,1179.05866,8.828947368,10409.84685,578.3248251,0.393019553
3.50877193,121,79,82,30,5,25,24,62.81851244,11,73,54,108,84,162,1035.555422,8.136986301,8426.300287,468.1277937,0.34518514
3.50877193,122,79,82,31,5,25,24,62.93416349,11,73,54,108,84,162,1035.555422,8.136986301,8426.300287,468.1277937,0.34518514
3.50877193,135,88,93,45,5,28,25,62.54343219,11,66,51,102,77,153,958.818341,8.5,8149.9559,452.7753276,0.31960611
3.50877193,146,91,98,38,5,32,30,60.10592596,11,82,66,132,93,198,1294.753445,8.853658537,11463.3049,636.8502715,0.431584482
3.508762696,127,81,84,33,5,28,24,62.62187698,11,76,57,114,87,171,1101.743338,8.25,9089.382537,504.9656965,0.367247779
3.508762696,128,81,84,33,5,28,24,62.62187698,11,76,57,114,87,171,1101.743338,8.25,9089.382537,504.9656965,0.367247779
3.409090909,131,86,89,32,5,27,24,61.50474052,12,77,61,121,89,182,1178.583484,9.428571429,11112.35857,617.353254,0.392861161
3.409090909,142,93,96,43,5,29,27,60.64469229,12,80,68,135,92,203,1324.283077,10.125,13408.36616,744.9092309,0.441427692
3.409090909,134,88,91,31,5,27,24,60.93539456,12,79,63,125,91,188,1223.465392,9.49367089,11615.17778,645.2876542,0.407821797
3.409018444,135,87,90,34,5,29,24,61.30397972,12,81,66,131,93,197,1288.214286,9.703703704,12500.44974,694.4694298,0.429404762
3.307981028,131,88,91,32,4,26,28,60.42254777,11,81,62,124,92,186,1213.382524,8.419753086,10216.38125,567.5767361,0.404460841
3.296703297,136,87,88,42,4,26,28,61.21278054,11,81,68,136,92,204,1330.806639,9.234567901,12289.42427,682.7457929,0.443602213
3.191489362,148,93,99,40,0,35,30,59.13397821,12,89,74,148,101,222,1478.122949,9.97752809,14748.01325,819.3340692,0.49270765
3.191489362,148,93,99,40,0,35,30,59.13397821,12,89,74,148,101,222,1478.122949,9.97752809,14748.01325,819.3340692,0.49270765
3.191489362,148,93,99,40,0,35,30,59.13397821,12,89,74,148,101,222,1478.122949,9.97752809,14748.01325,819.3340692,0.49270765
3.141361257,144,97,98,46,5,27,33,59.87865151,11,69,62,124,80,186,1175.878626,9.884057971,11622.4525,645.6918057,0.391959542
3.140014993,139,91,94,35,5,29,26,60.4040124,12,91,67,134,103,201,1343.986606,8.835164835,11874.3432,659.685733,0.447995535
5.172413793,115,74,79,19,4,25,22,62.05221458,11,60,46,92,71,138,848.6651025,8.433333333,7157.075698,397.6153165,0.282888367
4.761904762,105,68,74,30,0,22,20,65.8972721,11,52,37,74,63,111,663.4780715,7.826923077,5192.991829,288.4995461,0.221159357
4.545454545,152,100,105,25,5,31,31,56.6143651,11,76,66,132,87,198,1275.702812,9.552631579,12186.31897,677.0177205,0.425234271
4.410576539,115,69,74,28,4,27,20,65.76524689,12,55,40,80,67,120,727.9307029,8.727272727,6352.84977,352.9360984,0.242643568
3.947368421,131,85,86,40,4,24,27,61.89809257,11,76,61,122,87,183,1179.05866,8.828947368,10409.84685,578.3248251,0.393019553
3.947368421,133,88,89,42,4,23,28,61.29994564,11,77,64,128,88,192,1240.210871,9.142857143,11339.07082,629.9483788,0.413403624
3.947368421,133,88,89,45,4,23,28,61.37988579,11,77,64,128,88,192,1240.210871,9.142857143,11339.07082,629.9483788,0.413403624
3.947368421,130,85,86,40,4,23,27,61.79221725,11,77,63,126,88,189,1220.832576,9,10987.49318,610.416288,0.406944192
3.947368421,131,88,89,40,4,23,28,61.15960311,11,77,65,130,88,195,1259.589166,9.285714286,11696.18511,649.7880616,0.419863055
3.947368421,131,85,86,40,4,24,27,61.89809257,11,76,61,122,87,183,1179.05866,8.828947368,10409.84685,578.3248251,0.393019553
3.947368421,130,85,86,40,4,23,27,61.79221725,11,77,63,126,88,189,1220.832576,9,10987.49318,610.416288,0.406944192
3.947368421,133,88,89,45,4,23,28,61.37988579,11,77,64,128,88,192,1240.210871,9.142857143,11339.07082,629.9483788,0.413403624
3.947368421,130,85,86,40,4,23,27,61.79221725,11,77,63,126,88,189,1220.832576,9,10987.49318,610.416288,0.406944192
3.947368421,137,90,91,45,4,23,29,60.79005865,11,82,68,136,93,204,1333.988397,9.12195122,12168.57709,676.0320605,0.444662799
3.947368421,118,74,80,34,0,26,23,63.79731539,11,65,51,102,76,153,955.9329096,8.63076923,8250.436342,458.357575,0.318644303
3.785488959,142,86,91,44,6,32,27,61.63901883,12,82,65,130,94,195,1278.144826,9.512195122,12157.96298,675.4423878,0.426048275
3.50877193,121,79,82,30,5,25,24,62.81851244,11,73,54,108,84,162,1035.555422,8.136986301,8426.300287,468.1277937,0.34518514
3.50877193,122,79,82,31,5,25,24,62.93416349,11,73,54,108,84,162,1035.555422,8.136986301,8426.300287,468.1277937,0.34518514
3.50877193,135,88,93,45,5,28,25,62.54343219,11,66,51,102,77,153,958.818341,8.5,8149.9559,452.7753276,0.31960611
3.50877193,146,91,98,38,5,32,30,60.10592596,11,82,66,132,93,198,1294.753445,8.853658537,11463.3049,636.8502715,0.431584482
3.50877193,122,79,82,31,5,25,24,62.93416349,11,73,54,108,84,162,1035.555422,8.136986301,8426.300287,468.1277937,0.34518514
3.50877193,136,88,93,41,6,28,25,62.451717,11,65,51,102,76,153,955.9329096,8.63076923,8250.436342,458.357575,0.318644303
3.50877193,125,82,85,30,5,26,25,61.9316454,12,77,58,115,89,173,1120.301884,8.96103896,10039.06883,557.7260459,0.373433961
3.50877193,136,90,93,36,5,27,28,60.68833793,11,82,62,124,93,186,1216.283539,8.317073171,10115.91919,561.9955105,0.40542785
3.50877193,152,93,102,62,4,32,31,60.15786925,11,82,67,134,93,201,1314.370921,8.987804878,11813.30938,656.2949653,0.43812364
5.405405405,143,86,91,44,6,33,27,61.61806358,12,85,65,130,97,195,1286.983004,9.176470588,11809.96169,656.1089825,0.428994335
5.172413793,115,74,79,19,4,25,22,62.05221458,11,60,46,92,71,138,848.6651025,8.433333333,7157.075698,397.6153165,0.282888367
5.172413793,142,88,93,38,5,30,28,60.77814238,11,84,68,136,95,204,1340.250544,8.904761905,11934.61199,663.0339993,0.446750181
5.172413793,115,74,79,19,4,25,22,61.96706234,12,61,47,94,73,141,872.7652628,9.245901639,8069.50177,448.3056541,0.290921754
5.172413793,120,76,81,22,5,26,23,62.45533945,11,60,48,96,71,144,885.5635852,8.8,7792.95955,432.9421972,0.295187862
4.761904762,105,68,74,30,0,22,20,65.8972721,11,52,37,74,63,111,663.4780715,7.826923077,5192.991829,288.4995461,0.221159357
4.761904762,171,110,119,37,5,34,38,55.46991572,11,88,81,162,99,243,1610.933659,10.125,16310.70329,906.150183,0.536977886
4.629234067,134,87,88,43,4,24,27,61.29807098,12,85,69,138,97,207,1366.181958,9.741176471,13308.21955,739.3455304,0.455393986
4.54548691,153,100,105,44,5,32,31,59.29036455,11,77,67,134,88,201,1298.345755,9.571428571,12427.02366,690.3902032,0.432781918
4.545454545,152,100,105,25,5,31,31,56.6143651,11,76,66,132,87,198,1275.702812,9.552631579,12186.31897,677.0177205,0.425234271
4.545454545,152,100,105,25,5,31,31,56.6143651,11,76,66,132,87,198,1275.702812,9.552631579,12186.31897,677.0177205,0.425234271
4.410576539,115,69,74,28,4,27,20,65.76524689,12,55,40,80,67,120,727.9307029,8.727272727,6352.84977,352.9360984,0.242643568
4.410576539,119,70,75,28,6,28,20,65.54885485,12,59,43,86,71,129,793.317378,8.745762712,6938.165547,385.4536415,0.264439126
4.410576539,138,85,90,45,4,32,26,62.02947054,13,82,62,123,95,185,1215.423288,9.75,11850.37705,658.3542808,0.405141096
4.217185029,156,102,111,45,5,31,35,57.90923031,11,93,77,154,104,231,1547.801575,9.10752688,14096.64445,783.1469139,0.515933858
4.074702886,134,83,86,36,4,32,25,62.10230073,13,82,61,121,95,182,1195.713721,9.591463415,11468.64441,637.146911,0.39857124
3.947368421,131,85,86,40,4,24,27,61.89809257,11,76,61,122,87,183,1179.05866,8.828947368,10409.84685,578.3248251,0.393019553
3.947368421,133,88,89,42,4,23,28,61.29994564,11,77,64,128,88,192,1240.210871,9.142857143,11339.07082,629.9483788,0.413403624
3.947368421,133,88,89,45,4,23,28,61.37988579,11,77,64,128,88,192,1240.210871,9.142857143,11339.07082,629.9483788,0.413403624
3.947368421,130,85,86,40,4,23,27,61.79221725,11,77,63,126,88,189,1220.832576,9,10987.49318,610.416288,0.406944192
3.947368421,131,88,89,40,4,23,28,61.15960311,11,77,65,130,88,195,1259.589166,9.285714286,11696.18511,649.7880616,0.419863055
3.947368421,131,85,86,40,4,24,27,61.89809257,11,76,61,122,87,183,1179.05866,8.828947368,10409.84685,578.3248251,0.393019553
3.947368421,130,85,86,40,4,23,27,61.79221725,11,77,63,126,88,189,1220.832576,9,10987.49318,610.416288,0.406944192
3.947368421,133,88,89,45,4,23,28,61.37988579,11,77,64,128,88,192,1240.210871,9.142857143,11339.07082,629.9483788,0.413403624
3.947368421,130,85,86,40,4,23,27,61.79221725,11,77,63,126,88,189,1220.832576,9,10987.49318,610.416288,0.406944192
5.405405405,143,86,91,44,6,33,27,61.61806358,12,85,65,130,97,195,1286.983004,9.176470588,11809.96169,656.1089825,0.428994335
5.405405405,143,86,91,44,6,33,27,61.61806358,12,85,65,130,97,195,1286.983004,9.176470588,11809.96169,656.1089825,0.428994335
5.172413793,115,74,79,19,4,25,22,62.05221458,11,60,46,92,71,138,848.6651025,8.433333333,7157.075698,397.6153165,0.282888367
5.172413793,142,88,93,38,5,30,28,60.77814238,11,84,68,136,95,204,1340.250544,8.904761905,11934.61199,663.0339993,0.446750181
5.172413793,115,74,79,19,4,25,22,61.96706234,12,61,47,94,73,141,872.7652628,9.245901639,8069.50177,448.3056541,0.290921754
5.172413793,120,76,81,22,5,26,23,62.45533945,11,60,48,96,71,144,885.5635852,8.8,7792.95955,432.9421972,0.295187862
5.172413793,138,85,90,40,5,30,28,61.27450555,11,85,69,138,96,207,1363.087238,8.929411765,12171.56722,676.1981787,0.454362413
5.172413793,142,88,93,38,5,30,28,60.77814238,11,84,68,136,95,204,1340.250544,8.904761905,11934.61199,663.0339993,0.446750181
5.172413793,119,75,80,20,4,26,22,61.6139493,12,69,53,106,81,159,1008.03615,9.217391304,9291.463648,516.1924249,0.33601205
5.172413793,145,96,101,30,5,30,30,58.3277817,12,77,68,136,89,204,1321.04962,10.5974026,13999.69467,777.7608152,0.44034987
5.172413793,119,76,81,21,4,27,23,61.85265752,12,62,49,98,74,147,912.7896447,9.483870968,8656.779211,480.9321784,0.304263215
5.172413793,139,86,91,25,4,30,28,58.93544874,11,89,70,140,100,210,1395.2098,8.651685393,12070.91625,670.6064581,0.465069933
5.172400416,116,74,79,21,5,25,22,62.3751645,12,68,53,106,80,159,1005.186567,9.352941176,9401.450833,522.3028241,0.335062189
5.171031879,123,78,83,22,5,27,22,61.90354761,11,64,52,104,75,156,971.6957157,8.9375,8684.53046,482.4739144,0.323898572
5.042922896,135,88,89,44,4,24,27,61.1574655,12,85,70,140,97,210,1385.981697,9.882352941,13696.7603,760.9311277,0.461993899
4.961123161,134,87,88,43,4,24,27,61.29126084,12,86,69,138,98,207,1369.244938,9.627906977,13182.96289,732.3868272,0.456414979
4.958677686,155,92,101,51,6,37,31,60.23473262,12,91,69,138,103,207,1384.105609,9.098901099,12593.84005,699.65778,0.461368536
4.761904762,105,68,74,30,0,22,20,65.8972721,11,52,37,74,63,111,663.4780715,7.826923077,5192.991829,288.4995461,0.221159357
4.761904762,171,110,119,37,5,34,38,55.46991572,11,88,81,162,99,243,1610.933659,10.125,16310.70329,906.150183,0.536977886
4.761904762,171,110,119,37,5,34,38,55.46991572,11,88,81,162,99,243,1610.933659,10.125,16310.70329,906.150183,0.536977886
4.761904762,148,92,95,52,6,33,32,59.60889124,12,99,79,158,111,237,1610.27656,9.575757576,15419.61797,856.6454429,0.536758853
4.761904762,105,68,74,30,0,22,20,65.8972721,11,52,37,74,63,111,663.4780715,7.826923077,5192.991829,288.4995461,0.221159357
4.629234067,134,87,88,43,4,24,27,61.29807098,12,85,69,138,97,207,1366.181958,9.741176471,13308.21955,739.3455304,0.455393986
4.54548691,153,100,105,44,5,32,31,59.29036455,11,77,67,134,88,201,1298.345755,9.571428571,12427.02366,690.3902032,0.432781918
4.545454545,152,100,105,25,5,31,31,56.6143651,11,76,66,132,87,198,1275.702812,9.552631579,12186.31897,677.0177205,0.425234271
5.405405405,143,86,91,44,6,33,27,61.61806358,12,85,65,130,97,195,1286.983004,9.176470588,11809.96169,656.1089825,0.428994335
5.405405405,143,86,91,44,6,33,27,61.61806358,12,85,65,130,97,195,1286.983004,9.176470588,11809.96169,656.1089825,0.428994335
5.405405405,143,86,91,44,6,33,27,61.61806358,12,85,65,130,97,195,1286.983004,9.176470588,11809.96169,656.1089825,0.428994335
5.405405405,142,86,91,50,6,32,27,61.65317104,11,84,64,128,95,192,1261.412277,8.380952381,10571.83622,587.3242347,0.420470759
5.405405405,143,86,91,44,6,33,27,61.6249598,12,84,65,130,96,195,1284.067688,9.285714286,11923.48567,662.4158706,0.428022563
5.405405405,144,87,92,62,6,33,27,60.88012479,12,85,65,130,97,195,1286.983004,9.176470588,11809.96169,656.1089825,0.428994335
5.405405405,143,86,91,44,6,33,27,61.61806358,12,85,65,130,97,195,1286.983004,9.176470588,11809.96169,656.1089825,0.428994335
5.286365154,164,104,109,39,6,36,33,57.44266116,12,98,81,162,110,243,1647.87041,9.918367347,16344.18407,908.0102261,0.549290137
5.172413793,115,74,79,19,4,25,22,62.05221458,11,60,46,92,71,138,848.6651025,8.433333333,7157.075698,397.6153165,0.282888367
5.172413793,142,88,93,38,5,30,28,60.77814238,11,84,68,136,95,204,1340.250544,8.904761905,11934.61199,663.0339993,0.446750181
5.172413793,115,74,79,19,4,25,22,61.96706234,12,61,47,94,73,141,872.7652628,9.245901639,8069.50177,448.3056541,0.290921754
5.172413793,120,76,81,22,5,26,23,62.45533945,11,60,48,96,71,144,885.5635852,8.8,7792.95955,432.9421972,0.295187862
5.172413793,138,85,90,40,5,30,28,61.27450555,11,85,69,138,96,207,1363.087238,8.929411765,12171.56722,676.1981787,0.454362413
5.172413793,142,88,93,38,5,30,28,60.77814238,11,84,68,136,95,204,1340.250544,8.904761905,11934.61199,663.0339993,0.446750181
5.172413793,119,75,80,20,4,26,22,61.6139493,12,69,53,106,81,159,1008.03615,9.217391304,9291.463648,516.1924249,0.33601205
5.172413793,145,96,101,30,5,30,30,58.3277817,12,77,68,136,89,204,1321.04962,10.5974026,13999.69467,777.7608152,0.44034987
5.172413793,119,76,81,21,4,27,23,61.85265752,12,62,49,98,74,147,912.7896447,9.483870968,8656.779211,480.9321784,0.304263215
5.172413793,139,86,91,25,4,30,28,58.93544874,11,89,70,140,100,210,1395.2098,8.651685393,12070.91625,670.6064581,0.465069933
5.172413793,139,85,90,40,5,30,28,61.18071952,11,86,71,142,97,213,1405.781435,9.081395349,12766.45699,709.2476105,0.468593812
5.172413793,117,77,80,20,5,24,25,60.59720277,12,78,64,128,90,192,1246.435794,9.846153846,12272.5986,681.8110329,0.415478598
5.172413793,142,88,93,38,5,30,28,60.77814238,11,84,68,136,95,204,1340.250544,8.904761905,11934.61199,663.0339993,0.446750181
5.172413793,140,86,91,43,5,30,28,61.19232609,11,89,70,140,100,210,1395.2098,8.651685393,12070.91625,670.6064581,0.465069933
5.172413793,141,87,92,26,5,30,29,59.01102761,11,89,71,142,100,213,1415.141368,8.775280899,12418.26302,689.903501,0.471713789
5.172413793,129,82,87,17,5,28,26,58.387956,12,76,63,126,88,189,1220.832576,9.947368421,12144.07141,674.6706341,0.406944192
5.172413793,146,92,97,43,5,30,28,60.45685467,11,85,70,140,96,210,1382.842125,9.058823529,12526.92278,695.940154,0.460947375
5.940594059,158,96,101,45,9,34,33,58.98385567,12,99,81,162,111,243,1651.043056,9.818181818,16210.24091,900.5689394,0.550347685
5.607476636,144,89,94,28,6,30,30,58.96657003,12,90,74,147,102,221,1474.606001,9.8,14451.13881,802.8410448,0.491535334
5.405405405,143,86,91,44,6,33,27,61.61806358,12,85,65,130,97,195,1286.983004,9.176470588,11809.96169,656.1089825,0.428994335
5.405405405,143,86,91,44,6,33,27,61.61806358,12,85,65,130,97,195,1286.983004,9.176470588,11809.96169,656.1089825,0.428994335
5.405405405,143,86,91,44,6,33,27,61.61806358,12,85,65,130,97,195,1286.983004,9.176470588,11809.96169,656.1089825,0.428994335
5.405405405,142,86,91,50,6,32,27,61.65317104,11,84,64,128,95,192,1261.412277,8.380952381,10571.83622,587.3242347,0.420470759
5.405405405,143,86,91,44,6,33,27,61.6249598,12,84,65,130,96,195,1284.067688,9.285714286,11923.48567,662.4158706,0.428022563
5.405405405,144,87,92,62,6,33,27,60.88012479,12,85,65,130,97,195,1286.983004,9.176470588,11809.96169,656.1089825,0.428994335
5.405405405,143,86,91,44,6,33,27,61.61806358,12,85,65,130,97,195,1286.983004,9.176470588,11809.96169,656.1089825,0.428994335
5.405405405,144,86,91,44,6,33,27,61.6249598,12,84,65,130,96,195,1284.067688,9.285714286,11923.48567,662.4158706,0.428022563
5.405405405,143,86,91,44,6,33,27,61.61806358,12,85,65,130,97,195,1286.983004,9.176470588,11809.96169,656.1089825,0.428994335
5.405405405,143,86,91,44,6,33,27,61.61806358,12,85,65,130,97,195,1286.983004,9.176470588,11809.96169,656.1089825,0.428994335
5.405405405,143,87,92,43,6,32,27,61.47613749,12,85,65,130,97,195,1286.983004,9.176470588,11809.96169,656.1089825,0.428994335
5.405405405,144,87,92,62,6,33,27,60.88012479,12,85,65,130,97,195,1286.983004,9.176470588,11809.96169,656.1089825,0.428994335
5.405405405,145,87,92,62,6,33,27,60.88012479,12,85,65,130,97,195,1286.983004,9.176470588,11809.96169,656.1089825,0.428994335
5.405405405,142,86,91,51,6,32,27,61.6270361,11,84,64,128,95,192,1261.412277,8.380952381,10571.83622,587.3242347,0.420470759
5.405405405,153,91,96,48,7,35,32,60.06460759,12,93,72,144,105,216,1450.277032,9.290322581,13473.54146,748.5300809,0.483425677
5.405405405,143,86,91,50,6,32,27,61.65317104,11,84,64,128,95,192,1261.412277,8.380952381,10571.83622,587.3242347,0.420470759
5.405405405,145,88,93,63,6,33,27,60.63870839,12,88,67,134,100,201,1335.41509,9.136363636,12200.83791,677.8243281,0.445138365
5.405405405,149,85,90,60,6,38,26,61.11309406,11,90,68,136,101,204,1358.275142,8.311111111,11288.77563,627.1542016,0.452758381
5.405405405,148,91,96,40,6,32,28,60.70799795,11,84,65,130,95,195,1281.121844,8.511904762,10904.78712,605.8215067,0.427040615
5.345232888,164,103,108,66,6,37,33,58.00955428,12,104,84,168,116,252,1728.211211,9.692307692,16750.35481,930.575267,0.5760704
5.309734513,145,87,92,50,6,33,27,61.40956505,12,91,66,132,103,198,1323.927104,8.703296703,11522.5304,640.1405779,0.441309035
5.286365154,164,104,109,39,6,36,33,57.44266116,12,98,81,162,110,243,1647.87041,9.918367347,16344.18407,908.0102261,0.549290137
5.286365154,165,104,109,40,6,36,33,57.5415952,12,98,81,162,110,243,1647.87041,9.918367347,16344.18407,908.0102261,0.549290137
6.14334471,161,99,104,49,7,36,33,58.53132458,12,103,85,170,115,255,1745.599963,9.902912621,17286.52391,960.3624392,0.58186665
5.940594059,158,96,101,45,9,34,33,58.98385567,12,99,81,162,111,243,1651.043056,9.818181818,16210.24091,900.5689394,0.550347685
5.940594059,165,102,107,49,9,35,34,58.02120469,12,102,88,176,114,264,1803.882964,10.35294118,18675.49421,1037.527456,0.601294321
5.940594059,166,102,107,45,10,35,33,58.18499475,12,102,85,170,114,255,1742.386954,10,17423.86954,967.992752,0.58079565
5.940594059,157,96,101,46,8,34,33,58.98970476,12,98,81,162,110,243,1647.87041,9.918367347,16344.18407,908.0102261,0.549290137
5.940594059,163,97,102,44,12,35,33,58.91262221,12,99,81,162,111,243,1651.043056,9.818181818,16210.24091,900.5689394,0.550347685
5.940594059,166,101,106,49,8,37,34,58.2114217,12,102,85,170,114,255,1742.386954,10,17423.86954,967.992752,0.58079565
5.660377358,158,94,99,52,7,36,32,59.56250603,12,96,76,152,108,228,1540.11435,9.5,14631.08633,812.8381294,0.51337145
5.607476636,144,89,94,28,6,30,30,58.96657003,12,90,74,147,102,221,1474.606001,9.8,14451.13881,802.8410448,0.491535334
5.504587156,142,86,91,56,6,32,27,61.32488839,12,89,65,130,101,195,1298.35124,8.764044944,11378.80861,632.156034,0.432783746
5.453053301,149,97,102,49,7,30,36,58.29184987,13,111,85,170,124,255,1773.320059,9.954954955,17653.32131,980.7400728,0.591106686
5.405405405,143,86,91,44,6,33,27,61.61806358,12,85,65,130,97,195,1286.983004,9.176470588,11809.96169,656.1089825,0.428994335
5.405405405,143,86,91,44,6,33,27,61.61806358,12,85,65,130,97,195,1286.983004,9.176470588,11809.96169,656.1089825,0.428994335
5.405405405,143,86,91,44,6,33,27,61.61806358,12,85,65,130,97,195,1286.983004,9.176470588,11809.96169,656.1089825,0.428994335
5.405405405,142,86,91,50,6,32,27,61.65317104,11,84,64,128,95,192,1261.412277,8.380952381,10571.83622,587.3242347,0.420470759
5.405405405,143,86,91,44,6,33,27,61.6249598,12,84,65,130,96,195,1284.067688,9.285714286,11923.48567,662.4158706,0.428022563
5.405405405,144,87,92,62,6,33,27,60.88012479,12,85,65,130,97,195,1286.983004,9.176470588,11809.96169,656.1089825,0.428994335
5.405405405,143,86,91,44,6,33,27,61.61806358,12,85,65,130,97,195,1286.983004,9.176470588,11809.96169,656.1089825,0.428994335
5.405405405,144,86,91,44,6,33,27,61.6249598,12,84,65,130,96,195,1284.067688,9.285714286,11923.48567,662.4158706,0.428022563
5.405405405,143,86,91,44,6,33,27,61.61806358,12,85,65,130,97,195,1286.983004,9.176470588,11809.96169,656.1089825,0.428994335
5.405405405,143,86,91,44,6,33,27,61.61806358,12,85,65,130,97,195,1286.983004,9.176470588,11809.96169,656.1089825,0.428994335
5.405405405,143,87,92,43,6,32,27,61.47613749,12,85,65,130,97,195,1286.983004,9.176470588,11809.96169,656.1089825,0.428994335
5.405405405,144,87,92,62,6,33,27,60.88012479,12,85,65,130,97,195,1286.983004,9.176470588,11809.96169,656.1089825,0.428994335
5.405405405,145,87,92,62,6,33,27,60.88012479,12,85,65,130,97,195,1286.983004,9.176470588,11809.96169,656.1089825,0.428994335
5.405405405,142,86,91,51,6,32,27,61.6270361,11,84,64,128,95,192,1261.412277,8.380952381,10571.83622,587.3242347,0.420470759
6.976744186,183,110,115,56,8,43,39,56.38995758,12,114,94,188,126,282,1967.592938,9.894736842,19468.81434,1081.600797,0.655864313
6.593406593,182,110,115,53,8,42,38,56.41899704,12,113,96,192,125,288,2006.145874,10.19469027,20452.03581,1136.224212,0.668715291
6.25,172,104,109,63,7,39,38,57.03314106,12,110,92,184,122,276,1912.883505,10.03636364,19198.39445,1066.57747,0.637627835
6.14334471,161,99,104,49,7,36,33,58.53132458,12,103,85,170,115,255,1745.599963,9.902912621,17286.52391,960.3624392,0.58186665
6.14334471,166,103,108,50,7,37,34,58.0627955,12,104,83,166,116,249,1707.637268,9.576923077,16353.91076,908.550598,0.569212423
5.940594059,158,96,101,45,9,34,33,58.98385567,12,99,81,162,111,243,1651.043056,9.818181818,16210.24091,900.5689394,0.550347685
5.940594059,165,102,107,49,9,35,34,58.02120469,12,102,88,176,114,264,1803.882964,10.35294118,18675.49421,1037.527456,0.601294321
5.940594059,166,102,107,45,10,35,33,58.18499475,12,102,85,170,114,255,1742.386954,10,17423.86954,967.992752,0.58079565
5.940594059,157,96,101,46,8,34,33,58.98970476,12,98,81,162,110,243,1647.87041,9.918367347,16344.18407,908.0102261,0.549290137
5.940594059,163,97,102,44,12,35,33,58.91262221,12,99,81,162,111,243,1651.043056,9.818181818,16210.24091,900.5689394,0.550347685
5.940594059,166,101,106,49,8,37,34,58.2114217,12,102,85,170,114,255,1742.386954,10,17423.86954,967.992752,0.58079565
5.940594059,162,97,102,47,10,35,33,58.92405264,12,99,81,162,111,243,1651.043056,9.818181818,16210.24091,900.5689394,0.550347685
5.940594059,163,101,106,72,6,36,34,57.62772207,12,102,85,170,114,255,1742.386954,10,17423.86954,967.992752,0.58079565
5.940594059,158,96,101,55,9,34,33,58.93882331,12,99,81,162,111,243,1651.043056,9.818181818,16210.24091,900.5689394,0.550347685
5.940594059,164,101,106,52,7,36,34,58.24086838,12,102,85,170,114,255,1742.386954,10,17423.86954,967.992752,0.58079565
5.940594059,181,103,108,49,23,36,34,57.74473311,12,102,88,176,114,264,1803.882964,10.35294118,18675.49421,1037.527456,0.601294321
5.940594059,175,100,109,51,12,38,37,57.8992268,12,103,86,172,115,258,1766.136433,10.01941748,17695.65824,983.0921246,0.588712144
5.940594059,156,96,101,46,7,34,33,58.95801701,12,99,81,162,111,243,1651.043056,9.818181818,16210.24091,900.5689394,0.550347685
5.940594059,158,96,101,45,9,34,33,59.02748084,12,98,80,160,110,240,1627.526331,9.795918367,15943.11508,885.7286156,0.542508777
5.940594059,165,102,107,49,9,35,34,58.02120469,12,102,88,176,114,264,1803.882964,10.35294118,18675.49421,1037.527456,0.601294321
5.940594059,164,102,107,45,8,35,33,58.10633433,12,102,85,170,114,255,1742.386954,10,17423.86954,967.992752,0.58079565
5.940594059,167,101,106,49,9,37,34,58.22875926,12,102,85,170,114,255,1742.386954,10,17423.86954,967.992752,0.58079565
5.940594059,164,102,107,45,8,35,33,58.10633433,12,102,85,170,114,255,1742.386954,10,17423.86954,967.992752,0.58079565
5.940594059,166,102,107,45,10,35,33,58.18499475,12,102,85,170,114,255,1742.386954,10,17423.86954,967.992752,0.58079565
5.940594059,157,97,102,56,8,33,33,58.85831026,12,99,81,162,111,243,1651.043056,9.818181818,16210.24091,900.5689394,0.550347685
7.086614173,186,110,115,57,10,44,40,56.30043836,12,113,93,186,125,279,1943.453815,9.876106195,19193.75627,1066.319793,0.647817938
6.976744186,183,110,115,56,8,43,39,56.38995758,12,114,94,188,126,282,1967.592938,9.894736842,19468.81434,1081.600797,0.655864313
6.976744186,188,110,115,57,12,44,40,56.29007828,12,112,93,186,124,279,1940.220771,9.964285714,19332.91411,1074.050784,0.646740257
6.600149074,183,110,115,56,12,40,39,56.20026546,12,121,99,198,133,297,2095.418883,9.818181818,20573.20358,1142.955755,0.698472961
6.593406593,182,110,115,53,8,42,38,56.41899704,12,113,96,192,125,288,2006.145874,10.19469027,20452.03581,1136.224212,0.668715291
6.593406593,172,104,109,63,7,39,38,57.03314106,12,110,92,184,122,276,1912.883505,10.03636364,19198.39445,1066.57747,0.637627835
6.25,172,104,109,63,7,39,38,57.03314106,12,110,92,184,122,276,1912.883505,10.03636364,19198.39445,1066.57747,0.637627835
6.25,177,108,113,58,7,39,39,56.5089114,12,114,96,192,126,288,2009.456618,10.10526316,20306.08793,1128.115996,0.669818873
6.25,176,110,115,27,7,39,38,53.63794915,12,113,96,192,125,288,2006.145874,10.19469027,20452.03581,1136.224212,0.668715291
6.25,173,105,110,64,7,39,38,56.93122367,12,110,92,184,122,276,1912.883505,10.03636364,19198.39445,1066.57747,0.637627835
6.14334471,161,99,104,49,7,36,33,58.53132458,12,103,85,170,115,255,1745.599963,9.902912621,17286.52391,960.3624392,0.58186665
6.14334471,166,103,108,50,7,37,34,58.0627955,12,104,83,166,116,249,1707.637268,9.576923077,16353.91076,908.550598,0.569212423
6.14334471,161,99,104,49,7,36,33,58.53132458,12,103,85,170,115,255,1745.599963,9.902912621,17286.52391,960.3624392,0.58186665
6.14334471,168,103,108,50,9,37,34,58.14527566,12,103,82,164,115,246,1683.990553,9.553398058,16087.83207,893.7684486,0.561330184
6.14334471,166,103,108,50,8,36,34,58.08542185,12,104,83,166,116,249,1707.637268,9.576923077,16353.91076,908.550598,0.569212423
6.14334471,161,99,104,49,7,36,33,58.53132458,12,103,85,170,115,255,1745.599963,9.902912621,17286.52391,960.3624392,0.58186665
6.14334471,162,99,104,49,8,36,33,58.54852921,12,103,85,170,115,255,1745.599963,9.902912621,17286.52391,960.3624392,0.58186665
6.14334471,175,103,108,55,15,38,34,57.98688675,12,104,83,166,116,249,1707.637268,9.576923077,16353.91076,908.550598,0.569212423
5.940594059,158,96,101,45,9,34,33,58.98385567,12,99,81,162,111,243,1651.043056,9.818181818,16210.24091,900.5689394,0.550347685
5.940594059,165,102,107,49,9,35,34,58.02120469,12,102,88,176,114,264,1803.882964,10.35294118,18675.49421,1037.527456,0.601294321
5.940594059,166,102,107,45,10,35,33,58.18499475,12,102,85,170,114,255,1742.386954,10,17423.86954,967.992752,0.58079565
5.940594059,157,96,101,46,8,34,33,58.98970476,12,98,81,162,110,243,1647.87041,9.918367347,16344.18407,908.0102261,0.549290137
5.940594059,163,97,102,44,12,35,33,58.91262221,12,99,81,162,111,243,1651.043056,9.818181818,16210.24091,900.5689394,0.550347685
5.940594059,166,101,106,49,8,37,34,58.2114217,12,102,85,170,114,255,1742.386954,10,17423.86954,967.992752,0.58079565
5.940594059,162,97,102,47,10,35,33,58.92405264,12,99,81,162,111,243,1651.043056,9.818181818,16210.24091,900.5689394,0.550347685
7.086614173,186,110,115,57,10,44,40,56.30043836,12,113,93,186,125,279,1943.453815,9.876106195,19193.75627,1066.319793,0.647817938
6.976744186,183,110,115,56,8,43,39,56.38995758,12,114,94,188,126,282,1967.592938,9.894736842,19468.81434,1081.600797,0.655864313
6.976744186,188,110,115,57,12,44,40,56.29007828,12,112,93,186,124,279,1940.220771,9.964285714,19332.91411,1074.050784,0.646740257
6.600149074,183,110,115,56,12,40,39,56.20026546,12,121,99,198,133,297,2095.418883,9.818181818,20573.20358,1142.955755,0.698472961
6.593406593,182,110,115,53,8,42,38,56.41899704,12,113,96,192,125,288,2006.145874,10.19469027,20452.03581,1136.224212,0.668715291
6.593406593,172,104,109,63,7,39,38,57.03314106,12,110,92,184,122,276,1912.883505,10.03636364,19198.39445,1066.57747,0.637627835
6.25,172,104,109,63,7,39,38,57.03314106,12,110,92,184,122,276,1912.883505,10.03636364,19198.39445,1066.57747,0.637627835
6.25,177,108,113,58,7,39,39,56.5089114,12,114,96,192,126,288,2009.456618,10.10526316,20306.08793,1128.115996,0.669818873
6.25,176,110,115,27,7,39,38,53.63794915,12,113,96,192,125,288,2006.145874,10.19469027,20452.03581,1136.224212,0.668715291
6.25,173,105,110,64,7,39,38,56.93122367,12,110,92,184,122,276,1912.883505,10.03636364,19198.39445,1066.57747,0.637627835
6.14334471,161,99,104,49,7,36,33,58.53132458,12,103,85,170,115,255,1745.599963,9.902912621,17286.52391,960.3624392,0.58186665
6.14334471,166,103,108,50,7,37,34,58.0627955,12,104,83,166,116,249,1707.637268,9.576923077,16353.91076,908.550598,0.569212423
6.14334471,161,99,104,49,7,36,33,58.53132458,12,103,85,170,115,255,1745.599963,9.902912621,17286.52391,960.3624392,0.58186665
6.14334471,168,103,108,50,9,37,34,58.14527566,12,103,82,164,115,246,1683.990553,9.553398058,16087.83207,893.7684486,0.561330184
6.14334471,166,103,108,50,8,36,34,58.08542185,12,104,83,166,116,249,1707.637268,9.576923077,16353.91076,908.550598,0.569212423
6.14334471,161,99,104,49,7,36,33,58.53132458,12,103,85,170,115,255,1745.599963,9.902912621,17286.52391,960.3624392,0.58186665
6.14334471,162,99,104,49,8,36,33,58.54852921,12,103,85,170,115,255,1745.599963,9.902912621,17286.52391,960.3624392,0.58186665
6.14334471,175,103,108,55,15,38,34,57.98688675,12,104,83,166,116,249,1707.637268,9.576923077,16353.91076,908.550598,0.569212423
5.940594059,158,96,101,45,9,34,33,58.98385567,12,99,81,162,111,243,1651.043056,9.818181818,16210.24091,900.5689394,0.550347685
5.940594059,165,102,107,49,9,35,34,58.02120469,12,102,88,176,114,264,1803.882964,10.35294118,18675.49421,1037.527456,0.601294321
5.940594059,166,102,107,45,10,35,33,58.18499475,12,102,85,170,114,255,1742.386954,10,17423.86954,967.992752,0.58079565
5.940594059,157,96,101,46,8,34,33,58.98970476,12,98,81,162,110,243,1647.87041,9.918367347,16344.18407,908.0102261,0.549290137
5.940594059,163,97,102,44,12,35,33,58.91262221,12,99,81,162,111,243,1651.043056,9.818181818,16210.24091,900.5689394,0.550347685
5.940594059,166,101,106,49,8,37,34,58.2114217,12,102,85,170,114,255,1742.386954,10,17423.86954,967.992752,0.58079565
5.940594059,162,97,102,47,10,35,33,58.92405264,12,99,81,162,111,243,1651.043056,9.818181818,16210.24091,900.5689394,0.550347685
7.086614173,186,110,115,57,10,44,40,56.30043836,12,113,93,186,125,279,1943.453815,9.876106195,19193.75627,1066.319793,0.647817938
7.086614173,207,124,129,63,10,49,44,54.53050021,12,113,96,192,125,288,2006.145874,10.19469027,20452.03581,1136.224212,0.668715291
7.086614173,181,110,115,57,7,42,40,56.29299266,12,113,93,186,125,279,1943.453815,9.876106195,19193.75627,1066.319793,0.647817938
6.976744186,183,110,115,56,8,43,39,56.38995758,12,114,94,188,126,282,1967.592938,9.894736842,19468.81434,1081.600797,0.655864313
6.976744186,188,110,115,57,12,44,40,56.29007828,12,112,93,186,124,279,1940.220771,9.964285714,19332.91411,1074.050784,0.646740257
6.976744186,179,110,115,56,4,43,39,56.31886358,12,114,94,188,126,282,1967.592938,9.894736842,19468.81434,1081.600797,0.655864313
6.976744186,181,111,116,56,5,43,39,56.24043029,12,115,94,188,127,282,1970.809082,9.808695652,19331.06647,1073.948137,0.656936361
6.976744186,186,110,115,57,12,42,40,56.29007828,12,112,93,186,124,279,1940.220771,9.964285714,19332.91411,1074.050784,0.646740257
6.976744186,178,110,115,57,3,43,40,56.22696165,12,112,93,186,124,279,1940.220771,9.964285714,19332.91411,1074.050784,0.646740257
6.976744186,172,114,119,27,5,30,40,51.80677511,13,134,111,221,147,332,2390.291218,10.72014925,25624.27862,1423.571035,0.796763739
6.600149074,183,110,115,56,12,40,39,56.20026546,12,121,99,198,133,297,2095.418883,9.818181818,20573.20358,1142.955755,0.698472961
6.600149074,176,112,117,55,4,39,39,55.89746226,12,120,99,198,132,297,2092.185053,9.9,20712.63203,1150.701779,0.697395018
6.600149074,177,109,114,61,9,38,39,56.25333,12,121,99,198,133,297,2095.418883,9.818181818,20573.20358,1142.955755,0.698472961
6.600149074,179,110,115,68,7,40,39,56.0540635,12,121,99,198,133,297,2095.418883,9.818181818,20573.20358,1142.955755,0.698472961
6.593406593,182,110,115,53,8,42,38,56.41899704,12,113,96,192,125,288,2006.145874,10.19469027,20452.03581,1136.224212,0.668715291
6.593406593,172,104,109,63,7,39,38,57.03314106,12,110,92,184,122,276,1912.883505,10.03636364,19198.39445,1066.57747,0.637627835
6.593406593,176,106,111,64,7,40,40,56.4109186,12,114,97,194,126,291,2030.388458,10.21052632,20731.33478,1151.740821,0.67679615
6.593406593,172,104,109,63,7,39,38,57.03314106,12,110,92,184,122,276,1912.883505,10.03636364,19198.39445,1066.57747,0.637627835
6.593406593,185,112,117,54,8,42,38,56.17923691,12,114,98,196,126,294,2051.320298,10.31578947,21160.98833,1175.610463,0.683773433
6.593406593,188,114,119,57,8,43,39,55.83999547,12,116,100,200,128,300,2100,10.34482759,21724.13793,1206.896552,0.7
6.593401763,190,114,119,56,8,44,38,55.88891776,12,118,102,204,130,306,2148.844551,10.37288136,22289.70958,1238.317199,0.716281517
6.474820144,178,110,115,55,7,39,39,56.35852501,12,115,94,188,127,282,1970.809082,9.808695652,19331.06647,1073.948137,0.656936361
6.25,172,104,109,63,7,39,38,57.03314106,12,110,92,184,122,276,1912.883505,10.03636364,19198.39445,1066.57747,0.637627835
6.25,177,108,113,58,7,39,39,56.5089114,12,114,96,192,126,288,2009.456618,10.10526316,20306.08793,1128.115996,0.669818873
6.25,176,110,115,27,7,39,38,53.63794915,12,113,96,192,125,288,2006.145874,10.19469027,20452.03581,1136.224212,0.668715291
7.2,201,126,131,60,4,46,45,53.95478058,12,115,98,196,127,294,2054.673298,10.22608696,21011.26781,1167.292656,0.684891099
7.173596371,202,130,135,64,5,44,45,53.5669453,12,124,103,206,136,309,2190.026018,9.96774194,21829.61418,1212.756343,0.73000867
7.086614173,186,110,115,57,10,44,40,56.30043836,12,113,93,186,125,279,1943.453815,9.876106195,19193.75627,1066.319793,0.647817938
7.086614173,207,124,129,63,10,49,44,54.53050021,12,113,96,192,125,288,2006.145874,10.19469027,20452.03581,1136.224212,0.668715291
7.086614173,181,110,115,57,7,42,40,56.29299266,12,113,93,186,125,279,1943.453815,9.876106195,19193.75627,1066.319793,0.647817938
7.086614173,181,110,115,57,7,42,40,56.29299266,12,113,93,186,125,279,1943.453815,9.876106195,19193.75627,1066.319793,0.647817938
7.086614173,187,114,119,53,7,42,41,55.05127215,13,135,111,221,148,332,2393.538517,10.64074074,25469.02282,1414.945712,0.797846172
7.086614173,194,122,127,65,7,43,44,54.53149859,12,119,100,200,131,300,2110.0269,10.08403361,21277.58219,1182.087899,0.7033423
7.086614173,211,128,133,65,10,49,46,53.825527,12,115,100,200,127,300,2096.60541,10.43478261,21877.62163,1215.423424,0.698868469
7.086614173,186,113,118,58,7,43,40,55.8884303,12,116,97,194,128,291,2037,10.03448276,20440.24138,1135.568966,0.679
7.086614173,183,112,117,58,7,41,42,55.67325544,12,117,98,196,129,294,2061.300813,10.05128205,20718.71586,1151.03977,0.68710027
7.086614173,186,112,117,60,7,44,40,56.0566439,12,115,95,190,127,285,1991.775136,9.91304348,19744.55352,1096.91964,0.663925045
7.069539734,202,122,127,65,10,47,40,54.9083603,12,127,104,208,139,312,2221.109615,9.826771654,21826.337,1212.574278,0.740369872
7.069180151,184,113,118,34,7,42,40,54.14985756,12,120,96,192,132,288,2028.785506,9.6,19476.34086,1082.018937,0.676261835
7.03125,200,124,129,63,4,48,44,54.44488132,12,113,96,192,125,288,2006.145874,10.19469027,20452.03581,1136.224212,0.668715291
6.986814125,184,113,118,56,10,40,40,56.02580002,12,116,93,186,128,279,1953,9.620689655,18789.2069,1043.844828,0.651
6.982289574,184,115,120,64,8,40,40,55.54681556,12,127,101,202,139,303,2157.039145,9.543307087,20585.28696,1143.627053,0.719013048
6.976744186,183,110,115,56,8,43,39,56.38995758,12,114,94,188,126,282,1967.592938,9.894736842,19468.81434,1081.600797,0.655864313
6.976744186,188,110,115,57,12,44,40,56.29007828,12,112,93,186,124,279,1940.220771,9.964285714,19332.91411,1074.050784,0.646740257
6.976744186,179,110,115,56,4,43,39,56.31886358,12,114,94,188,126,282,1967.592938,9.894736842,19468.81434,1081.600797,0.655864313
6.976744186,181,111,116,56,5,43,39,56.24043029,12,115,94,188,127,282,1970.809082,9.808695652,19331.06647,1073.948137,0.656936361
6.976744186,186,110,115,57,12,42,40,56.29007828,12,112,93,186,124,279,1940.220771,9.964285714,19332.91411,1074.050784,0.646740257
6.976744186,178,110,115,57,3,43,40,56.22696165,12,112,93,186,124,279,1940.220771,9.964285714,19332.91411,1074.050784,0.646740257
6.976744186,172,114,119,27,5,30,40,51.80677511,13,134,111,221,147,332,2390.291218,10.72014925,25624.27862,1423.571035,0.796763739
6.976744186,179,110,115,56,4,43,39,56.31886358,12,114,94,188,126,282,1967.592938,9.894736842,19468.81434,1081.600797,0.655864313
7.2,201,126,131,60,4,46,45,53.95478058,12,115,98,196,127,294,2054.673298,10.22608696,21011.26781,1167.292656,0.684891099
7.173596371,202,130,135,64,5,44,45,53.5669453,12,124,103,206,136,309,2190.026018,9.96774194,21829.61418,1212.756343,0.73000867
7.086614173,186,110,115,57,10,44,40,56.30043836,12,113,93,186,125,279,1943.453815,9.876106195,19193.75627,1066.319793,0.647817938
7.086614173,207,124,129,63,10,49,44,54.53050021,12,113,96,192,125,288,2006.145874,10.19469027,20452.03581,1136.224212,0.668715291
7.086614173,181,110,115,57,7,42,40,56.29299266,12,113,93,186,125,279,1943.453815,9.876106195,19193.75627,1066.319793,0.647817938
7.086614173,181,110,115,57,7,42,40,56.29299266,12,113,93,186,125,279,1943.453815,9.876106195,19193.75627,1066.319793,0.647817938
7.086614173,187,114,119,53,7,42,41,55.05127215,13,135,111,221,148,332,2393.538517,10.64074074,25469.02282,1414.945712,0.797846172
7.086614173,194,122,127,65,7,43,44,54.53149859,12,119,100,200,131,300,2110.0269,10.08403361,21277.58219,1182.087899,0.7033423
7.086614173,211,128,133,65,10,49,46,53.825527,12,115,100,200,127,300,2096.60541,10.43478261,21877.62163,1215.423424,0.698868469
7.086614173,186,113,118,58,7,43,40,55.8884303,12,116,97,194,128,291,2037,10.03448276,20440.24138,1135.568966,0.679
7.086614173,183,112,117,58,7,41,42,55.67325544,12,117,98,196,129,294,2061.300813,10.05128205,20718.71586,1151.03977,0.68710027
7.086614173,186,112,117,60,7,44,40,56.0566439,12,115,95,190,127,285,1991.775136,9.91304348,19744.55352,1096.91964,0.663925045
7.069539734,202,122,127,65,10,47,40,54.9083603,12,127,104,208,139,312,2221.109615,9.826771654,21826.337,1212.574278,0.740369872
7.069180151,184,113,118,34,7,42,40,54.14985756,12,120,96,192,132,288,2028.785506,9.6,19476.34086,1082.018937,0.676261835
7.03125,200,124,129,63,4,48,44,54.44488132,12,113,96,192,125,288,2006.145874,10.19469027,20452.03581,1136.224212,0.668715291
6.986814125,184,113,118,56,10,40,40,56.02580002,12,116,93,186,128,279,1953,9.620689655,18789.2069,1043.844828,0.651
6.982289574,184,115,120,64,8,40,40,55.54681556,12,127,101,202,139,303,2157.039145,9.543307087,20585.28696,1143.627053,0.719013048
6.976744186,183,110,115,56,8,43,39,56.38995758,12,114,94,188,126,282,1967.592938,9.894736842,19468.81434,1081.600797,0.655864313
6.976744186,188,110,115,57,12,44,40,56.29007828,12,112,93,186,124,279,1940.220771,9.964285714,19332.91411,1074.050784,0.646740257
6.976744186,179,110,115,56,4,43,39,56.31886358,12,114,94,188,126,282,1967.592938,9.894736842,19468.81434,1081.600797,0.655864313
6.976744186,181,111,116,56,5,43,39,56.24043029,12,115,94,188,127,282,1970.809082,9.808695652,19331.06647,1073.948137,0.656936361
6.976744186,186,110,115,57,12,42,40,56.29007828,12,112,93,186,124,279,1940.220771,9.964285714,19332.91411,1074.050784,0.646740257
6.976744186,178,110,115,57,3,43,40,56.22696165,12,112,93,186,124,279,1940.220771,9.964285714,19332.91411,1074.050784,0.646740257
6.976744186,172,114,119,27,5,30,40,51.80677511,13,134,111,221,147,332,2390.291218,10.72014925,25624.27862,1423.571035,0.796763739
6.976744186,179,110,115,56,4,43,39,56.31886358,12,114,94,188,126,282,1967.592938,9.894736842,19468.81434,1081.600797,0.655864313
7.205764612,172,113,118,34,5,32,40,53.42457642,13,133,108,215,146,323,2322.313333,10.5075188,24401.75099,1355.652833,0.774104444
7.2,201,126,131,60,4,46,45,53.95478058,12,115,98,196,127,294,2054.673298,10.22608696,21011.26781,1167.292656,0.684891099
7.173596371,202,130,135,64,5,44,45,53.5669453,12,124,103,206,136,309,2190.026018,9.96774194,21829.61418,1212.756343,0.73000867
7.173596371,202,130,135,64,5,44,45,53.5669453,12,124,103,206,136,309,2190.026018,9.96774194,21829.61418,1212.756343,0.73000867
7.090946532,181,113,118,69,6,37,43,55.01241809,12,137,107,214,149,321,2317.353095,9.372262774,21718.84215,1206.602341,0.772451032
7.090946532,181,113,118,69,6,37,43,55.01241809,12,137,107,214,149,321,2317.353095,9.372262774,21718.84215,1206.602341,0.772451032
7.090946532,141,78,92,46,4,26,30,60.62072698,11,113,102,202,124,304,2114.075678,9.831858407,20785.29273,1154.738485,0.704691893
7.086614173,186,110,115,57,10,44,40,56.30043836,12,113,93,186,125,279,1943.453815,9.876106195,19193.75627,1066.319793,0.647817938
7.086614173,207,124,129,63,10,49,44,54.53050021,12,113,96,192,125,288,2006.145874,10.19469027,20452.03581,1136.224212,0.668715291
7.086614173,181,110,115,57,7,42,40,56.29299266,12,113,93,186,125,279,1943.453815,9.876106195,19193.75627,1066.319793,0.647817938
7.086614173,181,110,115,57,7,42,40,56.29299266,12,113,93,186,125,279,1943.453815,9.876106195,19193.75627,1066.319793,0.647817938
7.086614173,187,114,119,53,7,42,41,55.05127215,13,135,111,221,148,332,2393.538517,10.64074074,25469.02282,1414.945712,0.797846172
7.086614173,194,122,127,65,7,43,44,54.53149859,12,119,100,200,131,300,2110.0269,10.08403361,21277.58219,1182.087899,0.7033423
7.086614173,211,128,133,65,10,49,46,53.825527,12,115,100,200,127,300,2096.60541,10.43478261,21877.62163,1215.423424,0.698868469
7.086614173,186,113,118,58,7,43,40,55.8884303,12,116,97,194,128,291,2037,10.03448276,20440.24138,1135.568966,0.679
7.086614173,183,112,117,58,7,41,42,55.67325544,12,117,98,196,129,294,2061.300813,10.05128205,20718.71586,1151.03977,0.68710027
7.086614173,186,112,117,60,7,44,40,56.0566439,12,115,95,190,127,285,1991.775136,9.91304348,19744.55352,1096.91964,0.663925045
7.086614173,187,114,119,53,7,42,41,55.05127215,13,135,111,221,148,332,2393.538517,10.64074074,25469.02282,1414.945712,0.797846172
7.086614173,186,112,117,60,7,44,40,56.0566439,12,115,95,190,127,285,1991.775136,9.91304348,19744.55352,1096.91964,0.663925045
7.086614173,169,110,115,52,6,31,37,55.8218569,12,140,114,228,152,342,2478.79121,9.771428571,24221.33125,1345.629514,0.826263737
7.086614173,208,126,131,75,9,43,49,52.85337964,13,133,119,237,146,356,2559.577543,11.58270677,29646.83613,1647.046452,0.853192514
7.086614173,194,122,127,65,7,43,44,54.53149859,12,119,100,200,131,300,2110.0269,10.08403361,21277.58219,1182.087899,0.7033423
7.086614173,206,128,133,67,7,47,46,53.81944227,12,115,100,200,127,300,2096.60541,10.43478261,21877.62163,1215.423424,0.698868469
7.086614173,158,104,109,41,4,27,30,57.82881202,12,101,81,162,113,243,1657.303488,9.623762376,15949.49495,886.0830529,0.552434496
7.086614173,121,76,81,38,5,24,32,62.43706787,10,72,60,120,82,180,1144.359361,8.333333333,9536.328007,529.7960004,0.38145312
8.280421036,190,122,127,60,5,40,43,54.3154074,12,126,107,214,138,321,2281.836351,10.19047619,23252.999,1291.833278,0.760612117
8.280421036,188,115,120,62,7,42,40,55.6262098,12,120,100,200,132,300,2113.318236,10,21133.18236,1174.065687,0.704439412
8.280421036,124,73,78,37,6,24,23,64.15489294,9,75,58,116,84,174,1112.263232,6.96,7741.352092,430.0751162,0.370754411
7.614213198,179,112,117,60,6,37,42,55.67071748,12,119,98,196,131,294,2067.826362,9.882352941,20434.98993,1135.277219,0.689275454
7.432687722,177,117,122,34,5,33,40,52.64861404,13,142,115,229,155,344,2502.986795,10.48239437,26237.2947,1457.627482,0.834328932
7.432687722,177,117,122,34,5,33,40,52.64861404,13,142,115,229,155,344,2502.986795,10.48239437,26237.2947,1457.627482,0.834328932
7.432687722,124,73,78,37,6,24,23,64.15489294,9,75,58,116,84,174,1112.263232,6.96,7741.352092,430.0751162,0.370754411
7.432687722,181,121,126,23,4,34,44,49.31066998,12,119,100,200,131,300,2110.0269,10.08403361,21277.58219,1182.087899,0.7033423
7.432687722,171,99,113,57,5,30,40,56.22123796,12,142,127,252,154,379,2754.112099,10.64788732,29325.4753,1629.193073,0.918037366
7.432687722,168,114,119,37,5,30,32,55.11856012,13,120,101,198,133,299,2109.529448,10.725,22624.70333,1256.927963,0.703176483
7.205764612,172,113,118,34,5,32,40,53.42457642,13,133,108,215,146,323,2322.313333,10.5075188,24401.75099,1355.652833,0.774104444
7.205764612,173,114,119,35,5,32,40,53.313694,13,139,112,223,152,335,2428.055717,10.42805755,25319.90476,1406.661376,0.809351906
7.205764612,190,117,122,74,6,40,44,54.09752999,13,146,120,239,159,359,2625.324981,10.64041096,27934.5367,1551.918705,0.875108327
7.205764612,136,87,92,42,5,25,29,60.8940197,12,88,70,140,100,210,1395.2098,9.545454545,13317.91173,739.8839848,0.465069933
7.205764612,190,122,127,35,4,37,38,52.65837016,12,130,102,204,142,306,2187.822619,9.415384615,20599.19142,1144.399524,0.729274206
7.205764612,201,130,135,66,5,42,47,53.24178481,12,128,106,212,140,318,2267.111999,9.9375,22529.42549,1251.63475,0.755704
7.205764612,179,113,118,69,6,35,43,55.01241809,12,137,107,214,149,321,2317.353095,9.372262774,21718.84215,1206.602341,0.772451032
7.205764612,122,79,84,33,5,22,32,61.26816994,10,80,67,134,90,201,1304.862472,8.375,10928.22321,607.1235114,0.434954157
7.205764612,170,107,121,44,3,28,15.5,57.37524759,13,107,77,154,120,231,1595.491728,9.355140187,14926.0488,829.2249321,0.531830576
7.205764612,204,127,132,67,7,46,46,53.89755213,12,115,100,200,127,300,2096.60541,10.43478261,21877.62163,1215.423424,0.698868469
7.205764612,184,111,116,60,7,43,40,56.14149341,12,115,95,190,127,285,1991.775136,9.91304348,19744.55352,1096.91964,0.663925045
7.205764612,164,107,112,57,6,30,36,56.5715021,12,142,106,212,154,318,2310.83812,8.95774648,20699.90203,1149.994557,0.770279373
7.205764612,144,95,100,37,4,25,32,58.1108038,11,106,88,176,117,264,1813.776286,9.132075472,16563.54193,920.196774,0.604592095
7.205764612,192,114,119,66,10,45,39,56.09716414,12,112,90,180,124,270,1877.633004,9.642857143,18105.74682,1005.874823,0.625877668
7.2,201,126,131,60,4,46,45,53.95478058,12,115,98,196,127,294,2054.673298,10.22608696,21011.26781,1167.292656,0.684891099
8.280421036,190,122,127,60,5,40,43,54.3154074,12,126,107,214,138,321,2281.836351,10.19047619,23252.999,1291.833278,0.760612117
8.280421036,188,115,120,62,7,42,40,55.6262098,12,120,100,200,132,300,2113.318236,10,21133.18236,1174.065687,0.704439412
8.280421036,124,73,78,37,6,24,23,64.15489294,9,75,58,116,84,174,1112.263232,6.96,7741.352092,430.0751162,0.370754411
7.614213198,179,112,117,60,6,37,42,55.67071748,12,119,98,196,131,294,2067.826362,9.882352941,20434.98993,1135.277219,0.689275454
7.432687722,177,117,122,34,5,33,40,52.64861404,13,142,115,229,155,344,2502.986795,10.48239437,26237.2947,1457.627482,0.834328932
7.432687722,177,117,122,34,5,33,40,52.64861404,13,142,115,229,155,344,2502.986795,10.48239437,26237.2947,1457.627482,0.834328932
7.432687722,124,73,78,37,6,24,23,64.15489294,9,75,58,116,84,174,1112.263232,6.96,7741.352092,430.0751162,0.370754411
7.432687722,181,121,126,23,4,34,44,49.31066998,12,119,100,200,131,300,2110.0269,10.08403361,21277.58219,1182.087899,0.7033423
7.432687722,171,99,113,57,5,30,40,56.22123796,12,142,127,252,154,379,2754.112099,10.64788732,29325.4753,1629.193073,0.918037366
7.432687722,168,114,119,37,5,30,32,55.11856012,13,120,101,198,133,299,2109.529448,10.725,22624.70333,1256.927963,0.703176483
7.432687722,183,117,122,38,11,33,40,53.98335644,13,142,115,229,155,344,2502.986795,10.48239437,26237.2947,1457.627482,0.834328932
7.432687722,116,69,74,24,5,23,27,62.38387543,12,91,70,139,103,209,1397.47861,9.164835165,12807.66111,711.5367283,0.465826203
7.432687722,231,158,163,49,5,39,62,46.1827073,14,192,146,291,206,437,3359.00073,10.609375,35636.89837,1979.827687,1.11966691
7.432687722,180,119,124,38,5,33,40,52.91886687,13,145,118,235,158,353,2578.234604,10.53448276,27160.36798,1508.909332,0.859411535
7.432687722,201,130,135,66,5,42,47,53.24178481,12,128,106,212,140,318,2267.111999,9.9375,22529.42549,1251.63475,0.755704
7.432687722,174,114,120,58,7,27,47,54.6481114,12,124,103,204,136,307,2175.851092,9.870967742,21477.75594,1193.208663,0.725283697
7.432687722,126,67,72,34,6,24,27,63.17090252,9,100,83,166,109,249,1685.277897,7.47,12589.02589,699.3903272,0.561759299
7.432687722,195,128,133,43,4,37,44,51.65206736,13,152,123,245,165,368,2710.80657,10.47697368,28401.04915,1577.836064,0.903602192
7.432687722,173,116,121,45,6,30,31,55.89518776,13,121,105,206,134,311,2197.553738,11.0661157,24318.38393,1351.021329,0.732517913
7.432687722,148,97,102,46,3,26,32,58.72674994,10,101,83,166,111,249,1691.809551,8.217821782,13902.98938,772.3882987,0.563936517
7.432687722,161,108,113,30,5,25,39,54.31871236,12,103,88,176,115,264,1807.209373,10.25242718,18528.28251,1029.349028,0.602403124
7.432687722,148,95,100,30,3,30,32,57.65636504,13,89,71,140,102,211,1407.881747,10.2247191,14395.19539,799.7330773,0.469293916
7.205764612,172,113,118,34,5,32,40,53.42457642,13,133,108,215,146,323,2322.313333,10.5075188,24401.75099,1355.652833,0.774104444
7.205764612,173,114,119,35,5,32,40,53.313694,13,139,112,223,152,335,2428.055717,10.42805755,25319.90476,1406.661376,0.809351906
7.205764612,190,117,122,74,6,40,44,54.09752999,13,146,120,239,159,359,2625.324981,10.64041096,27934.5367,1551.918705,0.875108327
8.280421036,190,122,127,60,5,40,43,54.3154074,12,126,107,214,138,321,2281.836351,10.19047619,23252.999,1291.833278,0.760612117
8.280421036,188,115,120,62,7,42,40,55.6262098,12,120,100,200,132,300,2113.318236,10,21133.18236,1174.065687,0.704439412
8.280421036,124,73,78,37,6,24,23,64.15489294,9,75,58,116,84,174,1112.263232,6.96,7741.352092,430.0751162,0.370754411
8.280421036,190,122,127,60,5,40,43,54.3154074,12,126,107,214,138,321,2281.836351,10.19047619,23252.999,1291.833278,0.760612117
8.280421036,178,117,122,37,5,27,42,53.45596016,13,114,98,196,127,294,2054.673298,11.1754386,22961.87528,1275.659738,0.684891099
8.280421036,172,117,122,30,4,28,44,51.15310943,13,134,116,231,147,347,2498.286304,11.20522388,27993.85735,1555.214297,0.832762101
8.280421036,148,95,100,31,3,30,33,57.61387074,13,91,73,144,104,217,1453.995419,10.28571429,14955.38145,830.854525,0.48466514
8.280421036,148,97,102,46,3,26,32,58.72674994,10,101,83,166,111,249,1691.809551,8.217821782,13902.98938,772.3882987,0.563936517
8.280421036,197,132,137,31,6,33,50,49.09639579,13,148,109,218,161,327,2397.209819,9.574324324,22951.66428,1275.09246,0.79906994
8.280421036,154,100,105,30,5,26,36,55.57079931,12,128,96,190,140,286,2038.974943,8.90625,18159.62058,1008.86781,0.679658314
8.280421036,236,160,165,52,5,40,63,46.0483411,14,200,152,303,214,455,3522.367479,10.605,37354.7071,2075.261506,1.174122493
8.280421036,229,156,161,50,4,40,59,46.96417839,14,182,139,277,196,416,3167.719295,10.65384615,33748.394,1874.910779,1.055906432
8.280421036,145,96,101,43,4,25,32,58.91167109,11,101,78,156,112,234,1592.921052,8.495049505,13531.94319,751.774622,0.53097368
8.280421036,149,97,102,47,5,25,31,59.56039898,10,88,71,142,98,213,1408.933197,8.068181818,11367.5292,631.5294001,0.469644399
7.614213198,179,112,117,60,6,37,42,55.67071748,12,119,98,196,131,294,2067.826362,9.882352941,20434.98993,1135.277219,0.689275454
7.432687722,177,117,122,34,5,33,40,52.64861404,13,142,115,229,155,344,2502.986795,10.48239437,26237.2947,1457.627482,0.834328932
7.432687722,177,117,122,34,5,33,40,52.64861404,13,142,115,229,155,344,2502.986795,10.48239437,26237.2947,1457.627482,0.834328932
7.432687722,124,73,78,37,6,24,23,64.15489294,9,75,58,116,84,174,1112.263232,6.96,7741.352092,430.0751162,0.370754411
7.432687722,181,121,126,23,4,34,44,49.31066998,12,119,100,200,131,300,2110.0269,10.08403361,21277.58219,1182.087899,0.7033423
7.432687722,171,99,113,57,5,30,40,56.22123796,12,142,127,252,154,379,2754.112099,10.64788732,29325.4753,1629.193073,0.918037366
7.432687722,168,114,119,37,5,30,32,55.11856012,13,120,101,198,133,299,2109.529448,10.725,22624.70333,1256.927963,0.703176483
7.432687722,183,117,122,38,11,33,40,53.98335644,13,142,115,229,155,344,2502.986795,10.48239437,26237.2947,1457.627482,0.834328932
7.432687722,116,69,74,24,5,23,27,62.38387543,12,91,70,139,103,209,1397.47861,9.164835165,12807.66111,711.5367283,0.465826203
7.432687722,231,158,163,49,5,39,62,46.1827073,14,192,146,291,206,437,3359.00073,10.609375,35636.89837,1979.827687,1.11966691
7.432687722,180,119,124,38,5,33,40,52.91886687,13,145,118,235,158,353,2578.234604,10.53448276,27160.36798,1508.909332,0.859411535
8.280421036,190,122,127,60,5,40,43,54.3154074,12,126,107,214,138,321,2281.836351,10.19047619,23252.999,1291.833278,0.760612117
8.280421036,188,115,120,62,7,42,40,55.6262098,12,120,100,200,132,300,2113.318236,10,21133.18236,1174.065687,0.704439412
8.280421036,124,73,78,37,6,24,23,64.15489294,9,75,58,116,84,174,1112.263232,6.96,7741.352092,430.0751162,0.370754411
8.280421036,190,122,127,60,5,40,43,54.3154074,12,126,107,214,138,321,2281.836351,10.19047619,23252.999,1291.833278,0.760612117
8.280421036,178,117,122,37,5,27,42,53.45596016,13,114,98,196,127,294,2054.673298,11.1754386,22961.87528,1275.659738,0.684891099
8.280421036,172,117,122,30,4,28,44,51.15310943,13,134,116,231,147,347,2498.286304,11.20522388,27993.85735,1555.214297,0.832762101
8.280421036,148,95,100,31,3,30,33,57.61387074,13,91,73,144,104,217,1453.995419,10.28571429,14955.38145,830.854525,0.48466514
8.280421036,148,97,102,46,3,26,32,58.72674994,10,101,83,166,111,249,1691.809551,8.217821782,13902.98938,772.3882987,0.563936517
8.280421036,197,132,137,31,6,33,50,49.09639579,13,148,109,218,161,327,2397.209819,9.574324324,22951.66428,1275.09246,0.79906994
8.280421036,154,100,105,30,5,26,36,55.57079931,12,128,96,190,140,286,2038.974943,8.90625,18159.62058,1008.86781,0.679658314
8.280421036,236,160,165,52,5,40,63,46.0483411,14,200,152,303,214,455,3522.367479,10.605,37354.7071,2075.261506,1.174122493
8.280421036,229,156,161,50,4,40,59,46.96417839,14,182,139,277,196,416,3167.719295,10.65384615,33748.394,1874.910779,1.055906432
8.280421036,145,96,101,43,4,25,32,58.91167109,11,101,78,156,112,234,1592.921052,8.495049505,13531.94319,751.774622,0.53097368
8.280421036,149,97,102,47,5,25,31,59.56039898,10,88,71,142,98,213,1408.933197,8.068181818,11367.5292,631.5294001,0.469644399
7.614213198,179,112,117,60,6,37,42,55.67071748,12,119,98,196,131,294,2067.826362,9.882352941,20434.98993,1135.277219,0.689275454
7.614213198,176,112,117,60,3,37,42,55.63681087,12,119,98,196,131,294,2067.826362,9.882352941,20434.98993,1135.277219,0.689275454
7.614213198,82,58,59,6,3,14,12,61.5287177,10,50,35,70,60,105,620.2235125,7,4341.564588,241.1980327,0.206741171
7.614213198,196,138,143,35,3,29,46,48.94528945,14,145,115,229,159,344,2515.631737,11.05517241,27810.74258,1545.041254,0.838543912
7.614213198,158,102,107,33,5,27,36,55.593661,12,134,101,200,146,301,2164.137192,8.955223881,19380.33306,1076.68517,0.721379064
7.614213198,171,110,115,27,4,32,41,52.85615895,12,101,89,178,113,267,1820.987783,10.57425743,19255.59359,1069.755199,0.606995928
7.614213198,167,105,110,41,6,31,42,55.37548176,13,133,104,206,146,310,2228.845613,10.06766917,22439.28027,1246.626682,0.742948538
7.614213198,165,109,114,39,5,30,41,55.09207619,12,112,93,186,124,279,1940.220771,9.964285714,19332.91411,1074.050784,0.646740257
7.432687722,177,117,122,34,5,33,40,52.64861404,13,142,115,229,155,344,2502.986795,10.48239437,26237.2947,1457.627482,0.834328932
7.432687722,177,117,122,34,5,33,40,52.64861404,13,142,115,229,155,344,2502.986795,10.48239437,26237.2947,1457.627482,0.834328932
7.432687722,124,73,78,37,6,24,23,64.15489294,9,75,58,116,84,174,1112.263232,6.96,7741.352092,430.0751162,0.370754411
8.280421036,190,122,127,60,5,40,43,54.3154074,12,126,107,214,138,321,2281.836351,10.19047619,23252.999,1291.833278,0.760612117
8.280421036,188,115,120,62,7,42,40,55.6262098,12,120,100,200,132,300,2113.318236,10,21133.18236,1174.065687,0.704439412
8.280421036,124,73,78,37,6,24,23,64.15489294,9,75,58,116,84,174,1112.263232,6.96,7741.352092,430.0751162,0.370754411
8.280421036,190,122,127,60,5,40,43,54.3154074,12,126,107,214,138,321,2281.836351,10.19047619,23252.999,1291.833278,0.760612117
8.280421036,178,117,122,37,5,27,42,53.45596016,13,114,98,196,127,294,2054.673298,11.1754386,22961.87528,1275.659738,0.684891099
8.280421036,172,117,122,30,4,28,44,51.15310943,13,134,116,231,147,347,2498.286304,11.20522388,27993.85735,1555.214297,0.832762101
8.280421036,148,95,100,31,3,30,33,57.61387074,13,91,73,144,104,217,1453.995419,10.28571429,14955.38145,830.854525,0.48466514
8.280421036,148,97,102,46,3,26,32,58.72674994,10,101,83,166,111,249,1691.809551,8.217821782,13902.98938,772.3882987,0.563936517
8.280421036,197,132,137,31,6,33,50,49.09639579,13,148,109,218,161,327,2397.209819,9.574324324,22951.66428,1275.09246,0.79906994
8.280421036,154,100,105,30,5,26,36,55.57079931,12,128,96,190,140,286,2038.974943,8.90625,18159.62058,1008.86781,0.679658314
8.280421036,236,160,165,52,5,40,63,46.0483411,14,200,152,303,214,455,3522.367479,10.605,37354.7071,2075.261506,1.174122493
8.280421036,229,156,161,50,4,40,59,46.96417839,14,182,139,277,196,416,3167.719295,10.65384615,33748.394,1874.910779,1.055906432
8.280421036,145,96,101,43,4,25,32,58.91167109,11,101,78,156,112,234,1592.921052,8.495049505,13531.94319,751.774622,0.53097368
8.280421036,149,97,102,47,5,25,31,59.56039898,10,88,71,142,98,213,1408.933197,8.068181818,11367.5292,631.5294001,0.469644399
8.280421036,190,122,127,60,5,40,43,54.3154074,12,126,107,214,138,321,2281.836351,10.19047619,23252.999,1291.833278,0.760612117
8.280421036,130,84,89,30,6,20,24,60.50181971,13,102,83,164,115,247,1690.836043,10.45098039,17670.89433,981.7163515,0.563612014
8.280421036,166,102,107,44,5,29,37,56.4782778,12,140,107,212,152,319,2312.088877,9.085714286,21006.97894,1167.054385,0.770696292
8.280421036,153,100,105,49,3,27,33,58.26360322,10,103,86,172,113,258,1759.606172,8.349514563,14691.85736,816.214298,0.586535391
8.280421036,186,115,120,62,7,40,40,55.65677224,12,120,99,198,132,297,2092.185053,9.9,20712.63203,1150.701779,0.697395018
8.280421036,146,94,99,42,5,27,34,59.05062913,10,91,76,152,101,228,1518.072218,8.351648352,12678.40534,704.3558521,0.506024073
8.280421036,154,105,110,40,4,25,41,55.96443146,14,117,81,166,131,247,1737.25548,9.931623932,17253.76811,958.542673,0.57908516
8.280421036,193,123,128,63,5,40,43,54.20140685,12,129,110,220,141,330,2356.051946,10.23255814,24108.43852,1339.357696,0.785350649
8.280421036,188,115,120,62,7,42,40,55.6262098,12,120,100,200,132,300,2113.318236,10,21133.18236,1174.065687,0.704439412
8.280421036,144,92,101,31,5,20,38,56.70711451,11,123,90,180,134,270,1907.844081,8.048780488,15355.81822,853.101012,0.635948027
8.280421036,161,103,108,40,5,26,34,56.60558201,12,131,102,201,143,303,2169.441015,9.20610687,19972.10583,1109.561435,0.723147005
8.280421036,190,122,127,60,5,40,43,54.3154074,12,126,107,214,138,321,2281.836351,10.19047619,23252.999,1291.833278,0.760612117
8.280421036,188,115,120,62,7,42,40,55.6262098,12,120,100,200,132,300,2113.318236,10,21133.18236,1174.065687,0.704439412
8.280421036,124,73,78,37,6,24,23,64.15489294,9,75,58,116,84,174,1112.263232,6.96,7741.352092,430.0751162,0.370754411
8.280421036,190,122,127,60,5,40,43,54.3154074,12,126,107,214,138,321,2281.836351,10.19047619,23252.999,1291.833278,0.760612117
8.280421036,178,117,122,37,5,27,42,53.45596016,13,114,98,196,127,294,2054.673298,11.1754386,22961.87528,1275.659738,0.684891099
8.280421036,172,117,122,30,4,28,44,51.15310943,13,134,116,231,147,347,2498.286304,11.20522388,27993.85735,1555.214297,0.832762101
8.280421036,148,95,100,31,3,30,33,57.61387074,13,91,73,144,104,217,1453.995419,10.28571429,14955.38145,830.854525,0.48466514
8.280421036,148,97,102,46,3,26,32,58.72674994,10,101,83,166,111,249,1691.809551,8.217821782,13902.98938,772.3882987,0.563936517
8.280421036,197,132,137,31,6,33,50,49.09639579,13,148,109,218,161,327,2397.209819,9.574324324,22951.66428,1275.09246,0.79906994
8.280421036,154,100,105,30,5,26,36,55.57079931,12,128,96,190,140,286,2038.974943,8.90625,18159.62058,1008.86781,0.679658314
8.280421036,236,160,165,52,5,40,63,46.0483411,14,200,152,303,214,455,3522.367479,10.605,37354.7071,2075.261506,1.174122493
8.280421036,229,156,161,50,4,40,59,46.96417839,14,182,139,277,196,416,3167.719295,10.65384615,33748.394,1874.910779,1.055906432
8.280421036,145,96,101,43,4,25,32,58.91167109,11,101,78,156,112,234,1592.921052,8.495049505,13531.94319,751.774622,0.53097368
8.280421036,149,97,102,47,5,25,31,59.56039898,10,88,71,142,98,213,1408.933197,8.068181818,11367.5292,631.5294001,0.469644399
8.280421036,190,122,127,60,5,40,43,54.3154074,12,126,107,214,138,321,2281.836351,10.19047619,23252.999,1291.833278,0.760612117
8.280421036,130,84,89,30,6,20,24,60.50181971,13,102,83,164,115,247,1690.836043,10.45098039,17670.89433,981.7163515,0.563612014
8.280421036,166,102,107,44,5,29,37,56.4782778,12,140,107,212,152,319,2312.088877,9.085714286,21006.97894,1167.054385,0.770696292
8.280421036,153,100,105,49,3,27,33,58.26360322,10,103,86,172,113,258,1759.606172,8.349514563,14691.85736,816.214298,0.586535391
8.280421036,186,115,120,62,7,40,40,55.65677224,12,120,99,198,132,297,2092.185053,9.9,20712.63203,1150.701779,0.697395018
8.280421036,146,94,99,42,5,27,34,59.05062913,10,91,76,152,101,228,1518.072218,8.351648352,12678.40534,704.3558521,0.506024073
8.280421036,154,105,110,40,4,25,41,55.96443146,14,117,81,166,131,247,1737.25548,9.931623932,17253.76811,958.542673,0.57908516
8.280421036,193,123,128,63,5,40,43,54.20140685,12,129,110,220,141,330,2356.051946,10.23255814,24108.43852,1339.357696,0.785350649
8.280421036,188,115,120,62,7,42,40,55.6262098,12,120,100,200,132,300,2113.318236,10,21133.18236,1174.065687,0.704439412
8.280421036,144,92,101,31,5,20,38,56.70711451,11,123,90,180,134,270,1907.844081,8.048780488,15355.81822,853.101012,0.635948027
8.280421036,161,103,108,40,5,26,34,56.60558201,12,131,102,201,143,303,2169.441015,9.20610687,19972.10583,1109.561435,0.723147005
8.280421036,190,122,127,60,5,40,43,54.3154074,12,126,107,214,138,321,2281.836351,10.19047619,23252.999,1291.833278,0.760612117
8.280421036,188,115,120,62,7,42,40,55.6262098,12,120,100,200,132,300,2113.318236,10,21133.18236,1174.065687,0.704439412
8.280421036,124,73,78,37,6,24,23,64.15489294,9,75,58,116,84,174,1112.263232,6.96,7741.352092,430.0751162,0.370754411
8.280421036,190,122,127,60,5,40,43,54.3154074,12,126,107,214,138,321,2281.836351,10.19047619,23252.999,1291.833278,0.760612117
8.280421036,178,117,122,37,5,27,42,53.45596016,13,114,98,196,127,294,2054.673298,11.1754386,22961.87528,1275.659738,0.684891099
8.280421036,172,117,122,30,4,28,44,51.15310943,13,134,116,231,147,347,2498.286304,11.20522388,27993.85735,1555.214297,0.832762101
8.280421036,148,95,100,31,3,30,33,57.61387074,13,91,73,144,104,217,1453.995419,10.28571429,14955.38145,830.854525,0.48466514
8.280421036,148,97,102,46,3,26,32,58.72674994,10,101,83,166,111,249,1691.809551,8.217821782,13902.98938,772.3882987,0.563936517
8.280421036,197,132,137,31,6,33,50,49.09639579,13,148,109,218,161,327,2397.209819,9.574324324,22951.66428,1275.09246,0.79906994
8.280421036,154,100,105,30,5,26,36,55.57079931,12,128,96,190,140,286,2038.974943,8.90625,18159.62058,1008.86781,0.679658314
8.280421036,236,160,165,52,5,40,63,46.0483411,14,200,152,303,214,455,3522.367479,10.605,37354.7071,2075.261506,1.174122493
8.280421036,229,156,161,50,4,40,59,46.96417839,14,182,139,277,196,416,3167.719295,10.65384615,33748.394,1874.910779,1.055906432
8.280421036,145,96,101,43,4,25,32,58.91167109,11,101,78,156,112,234,1592.921052,8.495049505,13531.94319,751.774622,0.53097368
8.280421036,149,97,102,47,5,25,31,59.56039898,10,88,71,142,98,213,1408.933197,8.068181818,11367.5292,631.5294001,0.469644399
8.280421036,190,122,127,60,5,40,43,54.3154074,12,126,107,214,138,321,2281.836351,10.19047619,23252.999,1291.833278,0.760612117
8.280421036,130,84,89,30,6,20,24,60.50181971,13,102,83,164,115,247,1690.836043,10.45098039,17670.89433,981.7163515,0.563612014
8.280421036,166,102,107,44,5,29,37,56.4782778,12,140,107,212,152,319,2312.088877,9.085714286,21006.97894,1167.054385,0.770696292
8.280421036,153,100,105,49,3,27,33,58.26360322,10,103,86,172,113,258,1759.606172,8.349514563,14691.85736,816.214298,0.586535391
8.280421036,186,115,120,62,7,40,40,55.65677224,12,120,99,198,132,297,2092.185053,9.9,20712.63203,1150.701779,0.697395018
8.280421036,146,94,99,42,5,27,34,59.05062913,10,91,76,152,101,228,1518.072218,8.351648352,12678.40534,704.3558521,0.506024073
8.280421036,154,105,110,40,4,25,41,55.96443146,14,117,81,166,131,247,1737.25548,9.931623932,17253.76811,958.542673,0.57908516
8.280421036,193,123,128,63,5,40,43,54.20140685,12,129,110,220,141,330,2356.051946,10.23255814,24108.43852,1339.357696,0.785350649
8.280421036,188,115,120,62,7,42,40,55.6262098,12,120,100,200,132,300,2113.318236,10,21133.18236,1174.065687,0.704439412
8.280421036,144,92,101,31,5,20,38,56.70711451,11,123,90,180,134,270,1907.844081,8.048780488,15355.81822,853.101012,0.635948027
8.280421036,161,103,108,40,5,26,34,56.60558201,12,131,102,201,143,303,2169.441015,9.20610687,19972.10583,1109.561435,0.723147005